yes I saw Sally las night.	Commas after yes & no 	Capitalization
What happened on 2004, April 4.	Dates	Question marks
We should't go too close these porcupines there.	Those versus these
We shared Chloe and Jamals' pizza.	Compound possession
We practiced Will and her play.	Compound possession
We once hiked by a couple of deers on this trail.	Irregular plural nouns
We had sanga song before eating dinner.
We eat spicy chili pepers.
We ate boilling egg.	Verb tense
Those guys right here are my friends.	Those versus these
Those guys right here are my friends	Those versus these	Punctuation
this maan over there is my brother.	This versus that	Capitalization
This maan over there is my brother.	This versus that
There are some child living near the school.	Child versus children
Them and the teacher are going to the museum.	Subject pronouns
The zookeeper cleans the monkeys habitat.	Plural possessive nouns
The zookeeper clean's the monkey's habitat.	Plural versus possessive nouns
The tiger naps by the lions' cabe.
The teacher called on sam and me.	Capitalization
THe teacher called on Sam and me.	Capitalization
The pi was baked perfectly.
The panel of juges listen intently.	Subject-verb agreement
The pack of wolfs howld at the moon	Irregular plural nouns	Punctuation
The pack of wolfes homled at the moon	Irregular plural nouns	Punctuation
The Nile and The Congo are a river.	Singular and plural nouns
The nile and the congo are a river.	Singular and plural nouns	Capitalization
The Nile and the congo are a river.	Singular and plural nouns	Capitalization
The Nile and the congo are a river.	Singular and plural nouns	Capitalization
The Mount St . Helens erupted in 1980.	Articles	Spacing
The magpie his it's food in a little hole.	Its versus it's
The hunder terrifies he and his dog.	Object pronouns
The Himalayas are tall mountains in Asi.
The hairdresser cutted a lot of my hair.	Verb tense
The hairdesser cutted a lot of my hair.	Verb tense
The friends played with Lex and Tessan's cards.
The dogs ate the famil´y cake.	Possessive nouns
The construction worker, layedd the bricks.	Punctuation
The construction worker layed th bricks down.
The construction worker layed th bricks down	Punctuation
The Congo, a river in Africa, is 3000 miles long.	Commas in numbers
The congo, a river in Africa, is 3000 miles long.	Commas in numbers	Capitalization
The coach gave my team and I a pep talk.	Object pronouns
The coach asked him and Amari to lea the warm-up.
The coach asked he and Amari to lead the warm up.	Object pronouns
The chubby baby croud loudly in the high chair.
The cheetah runs faster than th lion.
The cat purring was quietly.	Scrambled words
The cat purred was quietly.	Run-on sentence
The casher rung up the groceries.	Verb tense
the bear is large,climbs up trees and is large	Repeated words	Spacing	Punctuation
The artist drew a picture of Erice and me.
Some deers have visited our backyard	Irregular plural nouns	Punctuation
She plays her piano beautifuly.
She isi't allowed in.
She hearded about the concert from my friend.	Verb tense
She gave the treacherthe finished homework.	Spacing
She and the chour are singing a new song tonight.
Raul looked and my brother and I painting.	Possessive pronouns	Compound possession
Please place these documents there into a folder.	Those versus these
Please place these documents there into a folder	Those versus these	Punctuation
Pauls' flight will belate because of a storm.	Possessive nouns	Spacing
Pauls' flight will be late because of the storm.	Possessive nouns
Nick cutted the paper for his project.	Verb tense
My sister has beeb studing spanish.	Capitalization
My losy ferret was in the yard this whole time.
My cousins went to visit las weekend.
Mount St. Helens eripted in 1980.
Mount St .Helens erupted in 1980.	Spacing
Mount St . Helens erupted in 1980.	Spacing
Milly had hes box of mollipedes in her desk.
Me and john were soaked from the rain.	Subject pronouns	Capitalization
Mariana eet yesterday salad for lunch.		Possessive nouns
mariana eats salad for lun ch yesterday	Capitalization	Spacing	Punctuation
mariana eats salad for luch every yesterday	Verb tense	Capitalization	Punctuation
mariana eats salad for her luch yesterday	Verb tense	Capitalization	Punctuation
Mariana ates salad for lunch yesterday.	Irregular past tense verbs
Lin wakted for the movie fo begin patiently.
Lin waited for the movie to begin patientily.
Lin waited for the movie fo begin patiently.
Last year, my tes her knew my name.
Last year, my teacher Kew my name.	Capitalization
Last year, my teacher Kew my name	Capitalization	Punctuation
Jake knee the answer, so he raised his hand.
Is that a best you've got?	Articles
Is Laura playing softball tomorrow.	Question marks
Inga held the baby duck gentlely.
I wiah I was an Olympic swimmer.
i whish i was an olympic.	Capitalization
i whish i was an olympic	Capitalization
I was listen to music when you called.	Verb tense
I was listen to music when you called	Verb tense	Punctuation
I usually walk to school, b ut normally I drive.	Spacing
I spook in class yesterday.
I lent my favorite books ro her and Adam.
I danced at Leslie's and thiers party.	Possessive pronouns
I danced at Leslie's and them party.	Possessive pronouns	Compound possession
I danced at Leslie and thier's party.	Possessive pronouns	Compound possession
I cutted up carrots for the soup.	Verb tense
I ate quickly beforegoing to the game.	Spacing
I am sorry that I brole your window.
How many potatos are you going to buy.	Irregular plural nouns	Question marks
How many potatos are you going to buy?	Irregular plural nouns
How many potatos are you goin to buy?	Irregular plural nouns
How many mans are going with ypu?	Man versus men
Him and Sonia are singing in the talent show.	Subject pronouns
He's a good soccer player, isant he	Question marks	Punctuation
He struggle with reading, but he wrote clear.	Subject-verb agreement	Adjectives versus adverbs
He sings really good.	Good versus well
Hammers are the most useful than tools.	Superlative and comparative adjectives
Hammers are the more useful tool.	Superlative and comparative adjectives
Hammers are most useful than tools.	Superlative and comparative adjectives
Do you want to go swimming with Jmal and me.	Question marks
Did you kno that Salvador Dali owned an anteater	Question marks	Punctuation
Cakeb tasted mine and Julie’s pie.	Possessive pronouns
Arielle can you come here? You should come here.	Commas for addressing people
Arielle can you come here?	Commas for addressing people
Arielle can you come here	Commas for addressing people	Question marks	Punctuation
Amir likes log and sprint.	Verb tense
Amir likes joggs and sprints.
Amir likes jogge and sprint.	Verb tense
Amir likes jogg and sprint.	Verb tense
Amir likes joge and sprint.	Verb tense
Amir likes jog and sprint.	Verb tense
Amir Likes jog and sprint.	Verb tense	Capitalization
Amir likes Jog and sprint.	Verb tense	Capitalization
Amir liked jog and sprint.	Verb tense
A hungry bear had eatern all the berries.
We and our freinds spent the day at the beach.
Me and my friend are starting a band.	Subject pronouns
Her and Marcus took a bow after the show.	Subject pronouns
Us and our freinds spent the day at the beach.	Subject pronouns
My friend and i are starting a band.	Capitalization
we and our freinds spent the day at the beach.	Capitalization
My freind and i are starting a band.	Capitalization
She and marcus took a bow after the show.	Capitalization
Hima and his family just got a new kitten	Subject pronouns	Punctuation
Raul looked and my brother and my painting.	Compound possession	Mixed up word
We went to the Tony's and her house for dinner.	Articles
Raul looked at my brothers and my painting.	Compound possession
We went to Tony and her's house for dinner	Possessive pronouns	Compound possession	Punctuation
I danced at Leslie and thier party.	Compound possession
I danced at Leslie and them's party.	Possessive pronouns	Compound possession
Caleb tasted Julie's and ours pie.	Possessive pronouns
We practiced will's and her play.	Capitalization
Elena borrowed Sasha's and his book .	Spacing
Raul looked and my brother's and my painting.	Mixed up word
Caleb tasted mine and Julie’s pie.	Possessive pronouns
Elena borrowed Sasha's and hims book.	Possessive pronouns
We went to the Tony and her house for dinner.	Compound possession	Articles
Elena borrowed Sasha's and him book.	Possessive pronouns
We wnet to Tony's and her house for dinner.
We went to Tony and her house for dinner.	Compound possession
Do you want to go swimming with Jamal and I.	Object pronouns	Question marks
The artist drew a picture of Erica and I.	Object pronouns
Im going to the movies, with her and Jacob.	Contractions	Commas with prepositional phrases
Do you want to go swiming with Jamal and me?
Im going to the movie’s with her and Jacob.	Plural versus possessive nouns	Contractions
Im going to the movies with her and Jacob.	Contractions
Do you want to go swimming with Jamal and I?	Object pronouns
You forgot to send Ryan and me your adress.
You forgot to send Ryan and I your address.	Object pronouns
The angry dog barked at Joey and I.	Object pronouns
The hunder terrifies him and his dog.
You forgot to send Ryan and I your adress.	Object pronouns
The teacher called on Sm and me.
Im going to the movies with her, and Jacob.	Contractions	Commas in compound objects
SHe beautifully plays the piano.	Capitalization
Liam sang he was loud.	Run-on sentence
She plays the piano beautful.	Adverbs versus adjectives
She plays her piano beautiful.	Adverbs versus adjectives
The quietly cat purred.	Adverbs
She plays the piano beautiful.	Adverbs versus adjectives
The cat purred was quiet.	Run-on sentence
This man over there is my brother.	This versus that
This ibrary over there is very popular.	This versus that
This library over there is very popular.	This versus that
This library is very over there is very popular.	This versus that	Scrambled words
This libary over there is very popular.	This versus that
This mean over there is my brother.	This versus that
Thatlibrary is very over there is very popular.	Scrambled words	Spacing
this library over there is very popular.	This versus that	Capitalization
This library over there is very popular	This versus that	Punctuation
this stained glass up there looks nice in the sun	This versus that	Capitalization	Punctuation
This stanied glass up there look nice in the sun.	Subject-verb agreement	This versus that
We ate all the plums which you bought.	Relative pronouns
I fed the brothers and sisters cat.	Compound possession
We shared Chloe's and Jamal pizza.	Compound possession
Paul borrowed Taylor and sam's book.	Capitalization
I bought cat and dog's food.	Articles
We we went for a ride in Annie and Swetha's car.	Repeated word
We shared the Chloe and Jamal' pizza.	Compound possession	Articles
We shared to Chloe and Jamal' pizza.	Compound possession	Extra word
We went for a ride in Annie and Swetha car	Compound possession	Punctuation
I fed the brothers' and sisters' cat.	Compound possession
Paul borrowed the Taylor's and sam's book.	Compound possession	Articles
We went for a ride in Annie and Swetha car.	Compound possession
I fed the brother’s and sisters cat.	Compound possession
I fed the brothers' and sisters cat.	Compound possession
I fed the brothers and sisiters' cat.
Paul borrowed the Taylor and sam's book.	Articles	Capitalization
The chef baked Mel and Jess's birthday came.
I fed the brother’s and sister’s cat.	Compound possession
The teacher speak kind	Subject-verb agreement	Adjectives versus adverbs	Punctuation
Yesterday, I speak with my friend.	Verb tense
I speak french well.	Capitalization
The teacher sopke kindly.
I sopke in class yesterday.
I speaked in class yesterday.	Irregular past tense verbs
She speaked with me last night.	Irregular past tense verbs
I speak in class yesterday.	Verb tense
The speak french well.	Capitalization
The teacher speak kindly.	Subject-verb agreement
Mariana ate salad for lucnh yeasterday	Punctuation
Mariana ate salad for yesterday lunch.	Possessive nouns
mariana eats salad yesterday	Verb tense	Punctuation
mariana eats salad for lucnh yesterday	Verb tense	Punctuation
Mariana ate salad for yesterdays lunch.	Possessive nouns
mariana eats salad for lunnch yesterday	Verb tense	Punctuation
mariana eats salad for lunche yesterday	Verb tense	Punctuation
Mariana eats yeasterday salad for lunch.	Possessive nouns
mariana eats salad for yesterday lunch	Verb tense	Possessive nouns	Punctuation
mariana eats salad for iunch yesterday	Verb tense	Punctuation
mariana eats salad for her dinner yesterday	Verb tense	Capitalization	Punctuation
mariana eats salad for lunch	Capitalization	Punctuation
Mariana eats yesterday lunch	Possessive nouns	Punctuation
mariana eats salad lunch for yesterday	Verb tense	Capitalization	Punctuation
Mariana eats yesterday salad for lunch.	Possessive nouns
mariana eats salad for yesterdays lunch	Verb tense	Possessive nouns	Punctuation
Mariana eats yesterday salad for lunch	Possessive nouns	Punctuation
Tiramisu, a Italian cake, is my favorite desert.	Articles
Batman has a cave and drives an fancy car.	Articles
The cheetah went faster then the lion.	Than versus then
The three womans chatted over lunch.	Woman versus women
These womans were hilarious.	Woman versus women
The womans on the street jog together.	Woman versus women
The womans formed a band.	Woman versus women
Those womans were hilarious.	Woman versus women
The womans on my street jog together.	Woman versus women
The college is full of smart woman.	Woman versus women
The college is full of smart womans.	Woman versus women
The two womans began the tennis match.	Woman versus women
The woman on my sreet jog together.	Woman versus women
There were more woman than men.	Woman versus women
Some child dont't know how to share.	Child versus children
She didnt do very well on her exam.	Contractions
walked across the bridge very slowly.	Fragment	Capitalization
Your graden looks beautiful.
I didnt know the answer, but i guessed correctly.	Contractions	Capitalization
I didn't know the answer but I guessed correctly.	Comma before coordinating conjunction
He is very good dancer.	Articles
your garden looks beautiful.	Capitalization
he sudden rain soaked though my coat.	Capitalization
Malik worte a thoughtfully thank-you card.	Adjectives versus adverbs
During the movi, I sat silently.
The warm air was strongly smelled of coffee.	Adverbs
A tall girl started intently at her homework.
A large dog sounly slept in the corner.
The cozy cafe buzzed with noisily activity.	Adjectives versus adverbs
The barusta carefully brewed the hot coffee.
The noisily cafe was cozy.	Adjectives versus adverbs
The cafe cozy buzzed noisily, activity.	Run-on sentence
The cafe buzzed noisily with cozy, activity.	Commas with adjectives
The cafe buzzed with activity, cozy, and noisily.	Adjectives versus adverbs
The cozy cafe buzzed noisily with acitivity.
The air smelled strongly of coffee was warm.	Run-on sentence
The cafe buzzed cozy, noisily, activity.	Run-on sentence
A woman quickly moved nerously toward the door.
I should have claened my room. I played a game.
the school ends when the bell rings.	Capitalization
Earth and moon are smaller than the sun.	Articles
The caital of France is Paris.
The capital of France in Paris.	Fragment
Himalayas are tall moutains in Asia.	Articles
Kangaroos live in Austraila.
Lodon is the capital of England.
Prowling around, lion hunted for dinner.	Articles
My favorite basebll team is the New York Yankees.
The Himalayas are tall moutains in Asia.
The Londo is the capital of England	Articles	Punctuation
a school ends when a bell rings.	Capitalization
I visited the Pyraminds of Giza.
london is the capital of england.	Capitalization
Himalayas are tall mountains in Asia.	Articles
Explorers found ruins of a ancient civilization.	Articles
mariana had salad for lunch yesterday.	Capitalization
Mariana eats salad lonch for yesterday	Verb tense	Punctuation
Mariana eated salad for lunch yesterday.	Irregular past tense verbs
I have seen the movie yesterday.	Verb tense
Mariana eat salad for lunch yesterday.	Verb tense
Mariana eat salad for lunch yesterday	Verb tense	Punctuation
Mariana eats salad for lunch yesterday	Verb tense	Punctuation
I Seen the movie yesterday.	Irregular past tense verbs
Mariana ate saland for lunch yesterday.
Before she went to the zoo, she never saw a lion.	Verb tense
We sang a sung before eating dinner.
She never saw a lion before going to the zoo.	Verb tense
We had sang song before eating dinner.	Verb tense	Articles
We had sang a song before eating dinner.	Verb tense
She is wears a beautiful wedding dress.	Verb tense
He's a good soccer player, isn't he.	Question marks
Do you want to go swimming with Jamal and me.	Question marks
When are you leaving home.	Question marks
Is he going to the dance tonight.	Question marks
Is he going to dance tonight.	Question marks
What am I going to eat for dinner/	Question marks	Punctuation
Can you tell Mom that I'll be home late.	Question marks
Is it going to rain today.	Question marks
Do you want to go swimming with Jamel and me.	Question marks
Where are we playing soccer.	Question marks
It is important for a children to get exercise.	Child versus children
The new horror movie is too scaryfor me.	Spacing
I grow tomatoes in my green garden.
The dog was yellow and hungry and feed the dog.
The old sleepy fisherman sat lazily on the shore.	Cumulative adjectives
You have wool, and two socks.	Comma before compound object
My neighbor drives ab old Japanese car.
The singer wears a velvet blue dress.	Cumulative adjectives
The president gave a French new speech.	Cumulative adjectives
The old sleepy fisherman sat laaily on the shore.
you have two wool socks.	Capitalization
The french bread is fresh and he loves bread.	Comma before coordinating conjunction	Capitalization
You have two and wool socks.	Extra word
are trying/have been trying	Fragment	Capitalization	Punctuation
is watching/has been watching	Fragment	Capitalization	Punctuation
is cheering/has been c	Fragment	Capitalization	Punctuation
are practicg/have been practicing	Fragment	Capitalization	Punctuation
is cheering/has been cheering	Fragment	Capitalization	Punctuation
is watching/has been watchi	Fragment	Capitalization	Punctuation
julia got a new phone	Capitalization	Punctuation
The chashier rung up my groceries.	Verb tense
The cashier was rung up my groceries.	Verb tense
The cashier rung up the my groceries.	Extra word	Verb tense
John had driven the racecar.	Spacing
The cashier rung up my groceries	Verb tense	Punctuation
The cashier rung up the groceries.	Verb tense
The constitution worker laid down the bricks.
The cashier rung up my groceries.	Verb tense
The large, brown, grizzly bear climbs up the tree	Cumulative adjectives	Punctuation
The large, brown, grizzy bear climbs up the tree.	Cumulative adjectives
The large, brown grizzly bear climbs up the tree.	Cumulative adjectives
Sam had a summer; as a result he earned monehy.	Comma after conjunctive adverb
Mix the sugar and butter. Add, the flour slowly.	Punctuation
We started by getting ice cream,	Punctuation
Next, the flour slowly.	Fragment
Mix the sugar and butter. Then, the flour slowly.	Fragment
Mix the sugar and butter. Then, the flour slowly	Fragment
I took a nap later I cleaned my room	Run-on sentence	Punctuation
I usully walk to school, but normally I drive.
I walk my dog regular.	Adverbs
In the winter, I go always skiing.	Adverbs
In the winter,I go skiing always.	Spacing
My techer gives our clases a week quiz.	Adverbs
My teacher gives our class a week quiz	Adverbs	Punctuation
My teacher gives out class a weekklt quiz.
My brother goes jogging daliy.
My teacher gives our class week quiz.	Adverbs
Sam goes to the gym already	Verb tense	Punctuation
I usually walk to school, but normally.I drive.	Punctuation
U usually walk to school, but normally I drive.
My teacher gives a week quiz.	Adverbs
My brother goes jogging day.	Adverbs
I walk my dog regul	Punctuation
The basketball team practices day	Adverbs	Punctuation
My brother goes jogging day	Adverbs	Punctuation
I usually walk to bschool, but normally.I drive.	Punctuation
Toucans have very colorfull beaks.
Toucans have very colorful becks.
The man tossed a frisbee on the front law.
The mans started a book club.	Man versus men
Nick cutthe paper or his project.	Spacing
I ct up carrots for the soup.
Nick cuted the paper for his project.	Verb tense
can you please help us,Frank?	Capitalization	Spacing
can you please help us,Frank	Capitalization	Spacing	Question marks
Let's eat ,John. Bob, you should go.	Spacing
Frank can you please help us?, please Frank	Commas for addressing people	Punctuation
Let's eat John,Bob, you should go.	Commas for addressing people	Run-on sentence
I saw sally last night.	Capitalization
No I can’t eat any more pizza.	Commas after yes & no
No I can't eat any more pizza.	Commas after yes & no
Yes I saw Sally last night.	Commas after yes & no
No we adopted a kitten yesterday.	Commas after yes & no
No I saw Sally last night.	Commas after yes & no
yes I saw sally last night.	Commas after yes & no 	Capitalization
She isn't allowed in,are you?	Spacing
She isn't allowed in,isn't she not allowed in?	Run-on sentence	Spacing
You, aren’t finishing that pizza.	Punctuation
We are going to the show,how about you?	Run-on sentence	Spacing
Yes, He's a good soccer player.	Capitalization
We are going to the show, you aren't?	Run-on sentence
We aren't going to the show, are you?	Run-on sentence
She isnt't allowed in here?
My hotel's address is, 121 Deck House Road,	Punctuation
The gopvernment meet to discuss the new law.	Subject-verb agreement
The team run out into the field.	Subject-verb agreement
The flock of birds flyy over the town.	Subject-verb agreement
The gopvernment meets to discuss the new law.
The flock of birds fly over the town.	Subject-verb agreement
The swarm of bees sleep in the hive.	Subject-verb agreement
The pod of whales float through the sea.	Subject-verb agreement
My new pair of shoes are already dirty.	Subject-verb agreement
Yesterday. a liter of kittens were born!	Subject-verb agreement	Punctuation
Yesterday, a litter of kitten were born!	Subject-verb agreement
The pack of dogs run after the birds.	Subject-verb agreement
A couple are holding hands at the bus stop.	Subject-verb agreement
Yesterday, a litter of kittens were born!	Subject-verb agreement
29 February 2008 was leap year.	Commas in dates
Why is September 2 1945 an important date?	Commas in dates
America began its civil war on April 12 1861.	Commas in dates
February 29,2008 was a leap year.	Commas in dates	Spacing
29 February 2008 was leap year.b	Commas in dates
What happend on April, 2004 4?
February 29th,2008 was a leap year.	Commas in dates	Spacing
What happend on 2004, 4 April?
What happened on May 25th 1955.	Commas in dates	Question marks
February 29th,2008, was a leap year.	Spacing
We moved to the USA on 1972, March, 12.	Commas in dates
29 February, 2008 was a leap year.	Commas in dates
President Obama assumed office on January20,2009.	Spacing
We moved to USA on 1972 March,12	Commas in dates	Punctuation
My sister was born on August 21st,2005.	Spacing
We moved to USA on 1972 March,12.	Commas in dates
February 29 2008, was a leap year.	Commas in dates
The moon has a craters and mountains.	Singular and plural nouns
The Nile and congo are a river.	Singular and plural nouns	Capitalization
He are friendly, patient,and honest.	Subject-verb agreement	Spacing
He am friendly, patient,and honest.	Subject-verb agreement	Spacing
He am friendly, patirnt, and honest.	Subject-verb agreement
He are friendly,patient,and honest.	Subject-verb agreement	Spacing
He are friendy, patient, and honest.	Subject-verb agreement
Los Angels is a city in California.
The Taj Mahal is a famous monumen in India.
There are 50 states in the Uniteed States.
Taj Mahal is a famous monument in India.
Joel has his head in a clouds.	Singular and plural nouns
I think those logs here are enough for a fire.	Those versus these
I think those logs here are enouyj	Those versus these	Punctuation
I think those logs are enough for a fire.	Those versus these
These campsites over the hill are the best ones.	Those versus these
These apples in that tree looks ripe.	Those versus these
That new computer here runs faster than taht one.	This versus that
That is my house right here.	This versus that
That chart here is a venn diagram.	This versus that	Capitalization
The bee flow after me!	Verb tense
Jupiter has moons and magnetic field.	Articles
Mars has low gravity and cold climate.	Articles
Milly had the box of mollipedes in her desk.
WE will need an big turkey or the stew.	Capitalization	Articles
Did you know that Salvador Dali owned a anteater	Articles	Question marks	Punctuation
A girl lives in a apartment in New York City.	Articles
There is a easy way to solve this problem	Articles	Punctuation
There's a open box on the table.	Articles
There is a easy way to solve this problem.	Articles
A apple a day keeps the doctor away.	Articles
I saw the oppportunity, so I took it.
There is a elephant on the plane, so be careful.	Articles
Did you know that Salvador Dali owned a anteater.	Articles	Question marks
the girl lives in a apartment in New York City.	Articles
There has to be a easy way out of this complex.	Articles
Did you know that Salvador Dali owned a anteater?	Articles
They went to a ice skating rink.	Articles
There is a elephant on the plane, so be carful.	Articles
Amelia Earhart bacame a great pilot.
Last year we become good friends.	Verb tense
Ben bacame tired as the day went on.
The runner break his shoes.	Verb tense
I brake my arm I was skating.	Run-on sentence
We build a birdhouse.	Verb tense
I build sands castles when I went to the beach.	Verb tense
I build a tree house last summer.	Verb tense
We build houses out of wood last week.	Verb tense
We built sand castles when we went to the beach.	Verb tense
I build sand castles when I went to the beach.	Verb tense
I builed a tree house last summer.	Verb tense
The possum hide in our backyardb during the day.	Subject-verb agreement
My friend does one hundred pushups and stopped.	Verb tense
I dig a deep hole and found the buried treasure.	Verb tense
The rabbits dig holes in the feild.
My mother goes to work this mornig.	Verb tense
this mornig, we were swimming at the beach.	Capitalization
I have ate at his restaurant every week.	Verb tense
Half ate strawberries were all over the floor.	Verb tense
I have ate deer meat.	Verb tense
A hungry bear had ate all the berries.	Verb tense
I have eated at this resturaunt every week.	Verb tense
Our chickens have ate all their food.	Verb tense
A cat has ate all the fish.	Verb tense
That half ate apple looks rotten.	Verb tense
The pandas have eated a lot of bamboo.	Verb tense
Half-ate strawberries were all over the floor.	Verb tense
Half ate strwberies were all over the floor.	Verb tense
Half eated strawberries were all over the floor.	Verb tense
The pandas have ate a lot of bamboo.	Verb tense
Have you ate pizza before?	Verb tense
My mother and my father do not has cars.	Subject-verb agreement
Ian worte a five-page essay.
Yesterday, we write a story in English class.	Verb tense
I worte a poem yesterday.
The nomadic tribe has go to where there is food.	Verb tense
JOsh has gone_overseas for a job interview.	Capitalization	Punctuation
The nomadic tribe had got to where there is food.	Verb tense
The heros were rewarded for their bravery.
Let's grow some tomato in our garden	Plural versus singular nouns	Punctuation
Did you put a lot of tomatos in this dinner.	Question marks
The heros are rewarded for their bravery.
Let's grow some tomatos in our garden.
The heros were rewarded for thir bravery.
Did you put a lot tomato in this dinner?	Missing word
Let's grow some tomatos	Punctuation
The hero's were rewarded for their bravery.	Plural versus possessive nouns
The flower grow fast when I watered it every day.	Subject-verb agreement	Verb tense
The naps' by the lions' cave.	Missing word
The monkeys' tease the lions' cubs'.	Plural versus possessive nouns
The lion steals food tigers belong to.	Scrambled words
The lion steals tigers food.	Possessive nouns
Both teams uniforms are purple and white.	Possessive nouns
The chirping birds' wakes up the tiger	Plural versus possessive nouns	Punctuation
I always borrow my two best friends clothes.	Possessive nouns
The lions steals the tigers' food.	Subject-verb agreement
The naps by the lions' cave.	Missing word
I always borrow my two best Friends clothes.	Possessive nouns	Capitalization
The zookeepers cleans' the monkeys habitat.	Possessive nouns
The lion steals the tigers food.	Possessive nouns
I saw Ben yesterday,he was wearing a new shirt.	Spacing	Run-on sentence
Ann can draw a dragon.she can also draw a flower.	Spacing	Capitalization
Ann can draw a Dragon.She can also draw a flower.	Spacing	Capitalization
I saw Ben yesterday. He wearing a new shirt.	Verb tense
Those toys weren't their.	Mixed up word
My hat is nice, but yous is better.	Possessive pronouns
The foxes nose wriggled out of curiosity.	Possessive nouns
My countries leaders decided to meet.	Possessive nouns
My friends calligraphy is improving.	Possessive nouns
My frend calligraphy is improving.	Possessive nouns
My country;s leaders decided to meet.	Possessive nouns
My cousin's live in Canada.	Plural versus possessive nouns
Our teams name is "The Funky Monkeys."	Possessive nouns
The Foxes nose wriggled out of curiosity.	Possessive nouns	Capitalization
Opera singers' have a very wide range.	Plural versus possessive nouns
The dogs ate the family cake.	Possessive nouns
She wrote her friend birthday card.	Articles
The dogs ate the family´ cake.	Possessive nouns
Andy favorite sport is basketball.	Possessive nouns
The dogs ate the families cake.	Possessive nouns
The detective looked for the robbers clues.	Possessive nouns
The cake was made from the grandmother´ recipe.	Possessive nouns
You Can use the bathroom when class is finished.	Capitalization
She hear about the concert from my friend.	Subject-verb agreement
I heared the bell ring.	Verb tense
My father heared the birds singing in the woods.	Verb tense
Yes,I am taking the bus.	Spacing
Marshmallows are light, fluffy , and sweet.	Spacing
The ocean is deep, dark ,and mysterious.	Spacing
Marshmallows are light , fluffy , and sweet.	Spacing
Cacti grow in the desert ,and they contain water.	Spacing
Desert animals adapt and,they learn to stay cool.	Comma before a coordinating conjunction
Marshmallows are light ,fluffy ,and sweet.	Spacing
Desert animals adapt,and they learn to stay cool.	Spacing
Cacti grow in the desert,and they contain water.	Spacing
After the beans are picked ,they are crushed.	Spacing
Marshmallows are light , fluffy, and sweet.	Spacing
Bats live in caves ,and they sleep upside down.	Spacing
"All right, I'll go with you,"said Jenny happily.	Spacing
Marshmallows are light, fluffy,and sweet.	Spacing
I was lisrening to music when u called	Punctuation
I was lsitening to music when you called.
the teacher is talking to a student right now.	Capitalization
he cleans the board at the moment.	Capitalization
Or friends are not leaving their houses.
We are leaving school at 3 every day.	Verb tense
We are leaving school at 3 ever day.	Verb tense
Are we stoping at the store?
The wait for the teacher every afternoon.
She is not driving a car to shool.
it is looking like it will snow soon.	Capitalization
Our friends will not leaving their houses.	Verb tense
Jupiter has moons and a magnetic fields.	Singular and plural nouns
I think I hurt me playing basketball yesterday	Reflexive pronouns	Punctuation
I think I hurt me playing basketball yesterday.	Reflexive pronouns
The pack of Wolfs howled at the Moon.	Irregular plural nouns	Capitalization
The pack of wolfes howled at the moon.	Irregular plural nouns
I visited three different citys.	Irregular plural nouns
The pack of wolfs howled at the moon	Irregular plural nouns	Punctuation
I visited three diffrent places.
I visited three different citys	Irregular plural nouns	Punctuation
The pack of wolf's howled at the moon.	Plural versus possessive nouns
The pack of wolf´s howled at the moon.	Plural versus possessive nouns
Ricardo bought tomorrow a new car	Verb tense	Punctuation
Our Engish teachern lead the choir next year	Verb tense	Punctuation
Ricardo buys a new car tomorrow	Verb tense	Punctuation
Ricardo aqquired a new car tommorrow	Verb tense	Punctuation
Our English teacher lead the choir next year.	Verb tense
I walk through Prospect Park next week.	Verb tense
He baked cookies for his friends next week.	Verb tense
Ricardo brought a new car tomorrow	Verb tense	Punctuation
Ricardo buys a new car tomorrow.	Verb tense
Please don't hurt youself.
You all made you into disciplinated athletes.	Reflexive pronouns
You all made yourself into disciplined.	Reflexive pronouns
You may all help you to some appetizers.	Reflexive pronouns
You may all help ypurselves to some appetizers.
I found a lost footage of the documentary.	Articles
The long loss sisters were reunited.	Verb tense
I solved most complicated problem on the exam!	Articles
I solved most complicated problem on the exam.	Articles
This is the cheaper price I have ever seen.	Superlative and comparative adjectives
i wish i was an olympic swimmer.	Capitalization
I wish it was warm so we could go to the beach	Comma before a coordinating conjunction	Punctuation
i wish she was coming to the beach with us.	Capitalization
I wish she was coing to the beach with us.
Them were told to leave there shoes outside	Subject pronouns	Possessive pronouns	Punctuation
Your can borrow my tools while they repair yours.	Subject pronouns
Bats eat peskey mosquitos, so bats are useful.
The woman began her prepared,brave hikek	Spacing	Punctuation
The woman began her prepared,brave hike	Spacing	Punctuation
The woman began her prepared,brave hike.	Spacing
She walked along the narrow and, muddy path.	Commas
a small bird flew up a treefast.	Spacing
she grabbed her bulky, heavy backpack.	Capitalization
The woman prepared,her brave hike.	Run-on sentence	Spacing
They predicted another cold windy day in seattle.	Coordinate adjectives
She walked along the narrow and muddy, path.
The women began the hikevshe was brave, prepared,	Punctuation
The women began the hikevshe was brave, prepared	Punctuation
The hiker reached the icy, rocky mountain peek.
My old and grumpy cat scratched my legs.
prepared and brave the woman began the hike.
Brave, prepared the woman began the hike.
Brave and prepared the woman began the hike.
She walked walked along the muddy, narrow path.
The brave prepared women began the hike.
The hiker looked at the tall cold mountain.
Micheal phelps swam in the olypics.
Micheal phelps swam in the olmypics.
Traveling is easy with a guide than without one.
Some bunnies are fluffiest than others.
Every day, My ring looks prettiest than before.
Is the teacher bought my new pencils.
I bougth an expensive dinner last night.
Jupiter has moon and magnetic field.
Spiderman can climb building and make spider webs
Astronomers study star and planets.
Ring appear around Jupiter and Saturn.
Africa and Asia have desert.
Rocket have gone to space stations and the moon.
Jupiter has moon and a magnetic field.
Rockets have gone to space station and the moon
Last night, I eat at my aunt's house.
Last night, I eat at my aunt’s house.
Yesterday, I meet with my teacher after school.
yersterday, I meet with my teacher after school.
Yesterday, I mer with my teacher after school.
Mr.brown payed me $10 to mow the lawn.
Rayna paied her bills.
Rayna payed her bills.
Mr. Brown payed me $10 to mow the lawn.
All the hard work payed off.
I reas a newspaper article yesterday.
I readed a newspaper article yesterday.
I red a newspaper article yesterday.
Standing in front of the class, Joe readed.
The docter misplaced his stethoscope.
The police officergot into the cop car.
After she fall, he knee had a large bruise.
After she fall, her knee had a large bruise.
She always spoke softly; to hear her.
She always spoke softly; had to listen closely.
Mary was; smart, kind, adn wise.
Mary was; smart, kind, and wise.
Mary can be described as; smart, kind, and wise.
mary was; smart, kind, and wise.
if someone wants to learn, you should teach them.
If someone wants to learn,you should teach them.
The are not feeling well today.
The beans are crushed after the bean are picked.
Each of the soccer players wear a green jersey.
Lions sleep durring the daytime.
some of the songs sounds really catchy.
Neither the dog nor the cat want to go outside.
Soem of the photos are out of focus.
Either Ariana or Gabr go to answer the door.
Each of the soccer players wear a grean jersey.
Either Ariana or Gabr goes to answer the door.
Many trees grows in the forest.
All of the chesse have gone bad.
Each of the soccer players wears a grean jersey.
we go to the park on Saturdays.
The music from the speakers are too loud.
Few people in the workd have red hair.
Something in the fridge smell bad.
nobody knows how to get there.
All of the chesse has gone bad.
The streets of Tokyo is bright.
some of the songs sound really catchy.
The cookies baking in the oven smells delicious.
nobody know how to get there.
Diego croosed the finish line victoriously.
Maria gave a confidently speech to the school.
The boys secretly planned birthday party.
Jose welcomed the warmly new student.
The happily pirates shared the treasure
Mateo thoughtfully out to sea.
Rico write a letter and he mails it quickly
Jose welcomed the new warmly student.
Latasha gracefully daces ballet.
Diego crossed bictoriously to the finish line.
The boys secretly plans a birthday party.
Latasha damces ballet gracefully.
Rico played his guitar then Rico went to sleep
Rico played his guitar then Rico went to sleep.
I heard you were colod, so I brung a jacket.
The mittens on the table have holes in it.
The singers in the choir can't hurt, their voice.
The cows in the herd eats their grass.
Keisha is a computer scientist she won the award
Keisha is a computer scientist she won a award.
Keisha was computer scientist you won an award
keisha a computer scientist
keisha won the award
Gizzly bears are 600 pounds and seven feet tall.
Alaska´swinter is very dark and snowy.
Alaska is large and clod.
Summer days are lang and warm.
Alaska's winters are very snowny and dark.
Summers days are long and warm.
Alaska is lage and cold.
Alask's winter is very snowy and dark.
The ocean is deep, dark, mysterious.
Marshmallows are fluffy,light,and sweet.
Marshmellowws are light, fluffy, and sweet.
Dumbledore is old, wise, and loved man.
The lantern is gold, shiny, magical.
Parrots are red, blue and yellor.
Tianna is smart, beauiful, and kind .
The lantern is gold, shiny, and is magical.
The mysterious Ocean is deep, it is dark.
Marshmallows are light, fluffy and, sweet.
Tianna is smart beautiful and kind.
Tianna is smart, beauiful, and kind.
LeLron James is tall, talented, and famous.
The lantern is gold, shiny , and magical.
Parrots are red, blue. and yellow.
The lantern is gold, shiny and, magical.
The ocean is deep,dark and mysterious.
No,I will drive you home.
When will Ramadan happen this Year
The hikers eat smores .
I ran home, when it started to rain.
Did you see the red leaves.
How many children do you have in the class.
Their is a bird nest in that tree
How many men are going with you.
America began it’s Civil War on April 12, 1861.
Do you want one napkin or two napkins
The student;s were whispering.
My parents left there keys at home
The tree is the winter loses her leaves .
The tree in the winter loses her leaves .
The student who the test congratuladet hiself
A lion in the tall grass stalks their pray.
THe audience clapped their hands.
The aduience clapped their hands.
The flock flapped their wing.
The team turned in their uniform.
My mom and my aunt take care their parents.
Frog and toads begin their lives in water.
By the time we garduate, we will learn so much.
The snow will have stop by April.
My arm will have heal by the end of this summer.
Several runners twisted their ankels.
Many clowns have itsown style of makeup.
Many clowns have its own style of makeup
Few fish raise thier young.
Few fish rais their young.
Both stundents have their own talents.
Many clowns have its own style of makeup.
Sevral runners twisted their ankles.
Few fish raise her young
I been to California three times so far.
The flock of goose flew up into the sky.
Have you send James lost cat?
Have you seen james lost cat?
Have you seen James lost cat?
the bus tires were huge.
I'm sorry that we foght.
The cats foughgt over the fish.
I send alot of messages last week.
I seted the present yesterday.
I send the present yesterday.
I send a lot of messages last week.
He send's his grandmother a nice card.
I set the present yesterday.
are cars invented in 1886?
When he makes a mistake, show him him to improve.
We ate my hamsters birthday cake.
Did you see the red leaf's.
I saw the cats kittens.
The student's were whispering.
I saw the presidents house.
I fed the goat's at the farm.
I like the firemans hat.
The bird's were singing.
All the girl's were laughing.
All of the girl's were laughing.
I can't read the teachers hanwriting.
We ate my sisters birthday cake.
The puppy aborabley wagged its tail.
The puppy adorablely wagged its tail.
He answered the question wisly.
I rarily go to the city.
You simplely flip the switch and it turns on.
That was a very nice cooked meal.
That was a amazingly cooked meal
The puppy adorabley wagged its tail.
He answered the question very wisly.
James accuratly impersonated the actor.
Jamed accuaritly impersonated the actor.
She gentlely picked the painting up.
That was very nice cooked meal.
Jamed accuaritelu impersonated the actor.
She gentily picked the painting up.
He rudly burped in front of everyone.
He rudly burped in front of everybody.
She gentley picked the painting up.
That was a amazing cooked meal
He rudeily burped in front of everybody.
The puppy adorabliy wagged its tall.
That was a very nicly cooked meal.
The students were tuaght by the Professor.
The rock in the path tripped adam.
The rocked in the path caused Adam to be tripped.
the scared children calmed down by natalie
The team are climim=ng the mountain.
The students were tuaght by the professor.
the oak tree was choped done by the lumberjack.
The rock in the path made Adam tripped over.
The room was clened by my mom.
The students where taught by the professor.
the pizza was bought
The rock in the path tripped Adamg
The car was rpaired by Sam.
The rock in the path tipped Adam.
The rocked in the path caused Adam to trip.
we lisened closly to the teacher
Casy bluntly ponted out the mistake i made.
My cosen carelessly threw his cloes on the floor.
She turned and stared at him cool
The servant carefaly pored tea for everyone.
The butter was lighted spread on the baglel.
she turned and stared at him coldly.
The car in front of us is movig far too slowly.
the butter was lightly sopreded on the bagel
The butter was lightly spread on the bagle
We listened closly to the teacher.
casey bluntly pointed out the miatacke I made.
the car in front of us is moving far to slowly
The car in front of us is moving far too slow.
The cheerleading team started it's cheer.
The flock of gesee lost its way.
The flock of gesse lost its way.
The flock's of geese lost their way.
The herd of buffalo Protected its young.
The herd of Buffalo Protected its young.
The flock of geeses lost their way.
The rock band finish its set.
The flock of geese their their way.
The flocks' of geese lost their way.
The flock of geeses its their way.
The rock band finised its set.
The flock of geese its their way.
The rock band finised their set.
I’m lost, went for the poor boy.
Roy confessed, "I was the one who ate the pizza".
My head hurts, the little girl whined.
Bill disagreed, That's not how the tides, work.
Bill disagreed, That's not how the tides work.
"I'm lost",whimpered the poor boy.
"I'm lost, whimpered the poor boy.
The sign states, " Do not walk on the grass".
“Watch your step”, warned the bus driver.
" I'm lost", whimpered the poor boy.
"My head hurt", the littlw girl whined.
" I'm lost",whimpered the poor boy.
“Watch your step”, warned the bus driver
The sign states, “Do not walk on the grass.
My head hurts, the little girl, whined.
I drpve my grandma to the doctor yesterday.
I drive for the first time yesterday.
I drived for the first time yesterday.
Some people are curiouser than others.
Some people are curiousest than others.
Some people are curiouest than others.
The bus arrived earlier than usal.
Some people are curiousiest than others.
Some people are curiousier than others.
Some people are more curios then other.vggbbbjuu
Some people are more curios then other.vggbbbjuun
That cheese is the stinkier thing ever.
who is the funnier person in class.
Who is the funnier person in class?
That cheese is stinrier thing ever.
That cheese is stinriest thing ever.
Tomorrow, you will driving us to the beach.
Tonight, Danielle will working late.
Katie will danceing at the talent show.
I will walking to school tomorrow.
This evening, Brianna will playing in the show.
Bill and I will be watch a movie tonight.
Tomorrow, you will be drive us to the beach.
Katie will be danceeing at the talent show.
I will be walk to school tomorrow.
Katie will dancing at the talent show.
Some mouse laugh when they are tickled.
I had some pet mouses when I was a kid.
Some mouses laugh when they are tickled.
I had some pet mouse when I was a kid.
I had some pet mouse when i was a kid.
paula finished the cleaning her.
The defiant little bird freed itfrom it's cage.
You think I was someone else.
I thaught school was closed yesterday.
You thoght thoght that I was someone else.
I think schoolwas closed yesterday.
Tonight we will treat us to a barecue
Tonight we will treat us to a barecue.
Let's assign us some tasks before splitting up.
We dressed us up in our Halloween costumes.
We make dinner every night this week.
The principal maked a speech.
I accidentally say on a wet bench.
I acciedentally sit on a wet bench.
She is very rude. Still I think she is funny.
He can't sing well. Still he practices every day.
She is very rude, still I think she is funny.
The zoo has three different kinds of wolfs.
The pizza was cut into two halfs.
I bought two loafs of bread at the at the store.
The chef uses many different knifes.
I'll have three loafs of bread, please.
A butcher uses different kinds of knifes
The ballet dancer had strond calfs.
The pizza was cut into two halfs
I'II have three loafes of bread, please.
He ate both havles of the cookie.
The ground was covered with leafs.
People dedicate their life to a greater cause.
Do you believe in elfs?
He ate both half of the cookie.
I bought two loaves of bread at the at the store.
The horse had four hoofs.
The ground was covered with leaf.
The pizza was cut into two half.
The zoo has three different kinds of wolvez.
How many person are showing up to the partfy?
How many peoplw are showing up to the party?
How many person are showing upto the partfy?
Does anyone want to give his prsentation.
Does anyone want to give his presentation first.
Does anyone want to give a presentation first.
Does anyone want to give his presentation.
They cheer while fans watch football.
It turns to liquid when rock becomes very hot.
They hire coaches or athletes coach themselves.
They hire coaches, or athletes coach themselves.
Gas builds up inside it until a volcano explodes
Gas builds up inside it until a volcano explodes.
It is considered dormant until a volcano erupts.
It turns to liquid, when rock becomes very hot.
They are crushed after the beans are picked.
I just had all of my wisdom tooths pulled
I just had all of my wisdom teets pulled.
I just had all of my wisdom teets pulled
I just had all of my wisdom tooths pulled.
Have you lost all you baby teeth yet?
Have u lost all your baby tooths yet?
Have you lost all of your baby tooth yet?
Have u lost all your baby teeth yet?
Have you lost all of your baby tooths yet?
I thought running washard when i was in school.
She is the best dancer when she was a kid.
I thought running is hard when i was in school
Last week, the homework as challenging.
I thought running is hard when I was in school.
I now understand what I receive a B in this paper
I now understand when Ireceived
Is there a reason where you want my help
Is there a reasom]
Is there a reason where you want my help?
Is there a reason that you want my help?
What is the reason y
Is there a reason when you want my help.
Is there a reason why you want to help me.
Is there a reason why you want to help me?
Is there a reason why you don’t want to help me?
What is the reason
Is there a reason when you want my help?
Is there a reason When you want my help?
Is there a reason were you want my help?
I now understand when,Ireceived
Is there a reason when you want my help
Is there a reason when you want my help ?
Is there a reason were you want my help.
Van Gogh, was an artist who painted Starry Night.
Pharaohs were royalty that ruled ancient Egypt.
I know someone whom drives to recklessly.
Pharaohs were royalty who ruled ancient Egypt
Barry, whom direted the play, is also a singer.
Does anybody know Who's sandwiches these are?
I want to adpot a kitten whose nose is pink.
I want to adpot a kitten whose nose is pink
I want to adapt a kitten whose nose is pink.
I wnat to adopt a kitten whose nose is pink.
Does anybody know Whose sandwiches these are?
Does anybody know who's sandwiches these are?
I want to adopt a kitten who's nose is pink.
Dose anybody know whose sandwiches these are?
I hope I do well on the next test.
He says choclate is best than vanilla.
I hope I do best on the next test.
Ihope I do good on the next test.
Those boots are best for hiking than running.
He says the chocolate is best vanilla.
He says chocolate is best vanilla.
I hope I do great on the next test.
My headache got worst before it go better.
Standing out in the rain made my cold worst.
My headaches got worst before it got better.
My headache got wose before it got better.
My headache got worst before it got better.
Standind out in the rain made my cold bad.
Standing out in the rain made my cold wor
My headache got worst befor it got better.
My headache got bad] before it got better.
This movie is not good, but I’ve seen bad movies.
Bill thinks he is better at everything.
Bill thinks he's the best at every thing.
I like this movie most of all.
I like this movie the most of all.
Bill thinks he is good at everything.
Bill thinks he is beter at everything.
I like this movie the better of all.
I like this movie the good of all.
It's a beatiful Spring day. We can eat outside.
We may definitely win the championship game.
It's a beautiful spring day. We can eat outside.
we may definitely win the championship game.
May you help me lift the couch?
we would pratice more for our game next week.
We would practice more for our game next week.
Should i have some more milk please?
We would pratice more for our game next week.
I should like to ride my bike after schol.
Should you like to play soccer tomorrow?
We would bring soup to our sick friend.
We should do the dishes before mom gets home.
You would stop smoking becuse it is bad for y
Tianna is smart, beautiful and kind.
Marshmallows are light, fluffy and sweet.
mint, lavender, sunflowers and cucumbers
Some good spices are persely sage, thyme.
Parrots are red, blue and yellow.
We play many instruments
Daniel, who I saw yesterday,is looking healthier.
The pennys were old and rusty.
I finished my activity.
The pennys were pennies were old and rusty.
The pennies were pennies were old and rusty.
The pennyies were old and rusty.
The bear ate red berrys.
My aunt has two babys
I finshed my activity.
Right now is the badiest time to call me.
Right now is the worse time to call me.
This is the worse storm I've ever seen
This is the worst storm I have ever seen.
This is the worse storm I've ever seen.
