this only affected 25 women.	Affected_More_Men		
the cuts only affected 25 women whereas 58 men were affected.	Affected_More_Men		
it made more significant cuts to the men's athletics programs.	Affected_More_Men		
cut more men's sports then women's.	Affected_More_Men		
they cut more from men's sports.	Affected_More_Men		
also cut even more mens sport activities.	Affected_More_Men		
Cuts to the men’s teams would affect more men than women.	Affected_More_Men		
more male athletes were affected.	Affected_More_Men		
the overall changes affected more men than women in actuality.	Affected_More_Men		
the cuts affected more men than women.	Affected_More_Men		
it was penalized for doing so despite equal cuts to male teams which resulted in a higher impact in male sports participation.	Affected_More_Men		
according to the study, it effected more men than women.	Affected_More_Men		
the school argued it affected more men then women.	Affected_More_Men		
argued that the changes affected more men than women.	Affected_More_Men		
the school argued that the changes affected more men than women.	Affected_More_Men		
the changes affected more men than women.	Affected_More_Men		
actually ended up affecting more men then women.	Affected_More_Men		
the changes effected more men than women.	Affected_More_Men		
insisted the cuts would impact men more than women.	Affected_More_Men		
more men were affected than women	Affected_More_Men		
the changes affected more men than women	Affected_More_Men		
most of those affected by these cuts were men.	Affected_More_Men		
the overall sports cuts affected more men than women.	Affected_More_Men		
the cuts affected more women than men.	Affected_More_Men		
the changes affected more men than it did women.	Affected_More_Men		
they argued the cuts would effect more men than women.	Affected_More_Men		
the university argued that the cuts affected more men than women.	Affected_More_Men		
argued that the cuts affected the men's teams more than the woman's	Affected_More_Men		
claimed that more men than women were affected by cuts in sports programs.	Affected_More_Men		
more men were effected by the cuts.	Affected_More_Men		
they also cut a number of men's teams that would affect their male athlete population to a greater extent.	Affected_More_Men	Cuts_to_mens_sports	
also cut men’s teams that resulted in more men bing dropped from sports that fall.	Affected_More_Men	Cuts_to_mens_sports	
they also cut men's sports and more men lost their chance to play their sport than women.	Affected_More_Men	Cuts_to_mens_sports	
they also cut men's sports which actually resulted in more men being out of sports than women.	Affected_More_Men	Cuts_to_mens_sports	
also cut men's wrestling, swimming, and diving, affecting way more men than women.	Affected_More_Men	Cuts_to_WSD	
they also cut men's wrestling, men's swimming and diving which impacted more men than women at the school; however the school has 60% female students and less females are involved in sports, so they argued that the budget disproportionately impacted females.	Affected_More_Men	Cuts_to_WSD,	
the school claimed it did not violate Title IX because the changes affected more men than women and it wasn’t making their sports programs more unfair for women.	Affected_More_Men	EMU_compliant	
claimed this did not violate Title IX because the overall cuts affected more male athletes than female athletes.	Affected_More_Men	EMU_compliant	
claimed that they did not violate Title IV since more men were affected by overall cuts than women.	Affected_More_Men	EMU_compliant	
insisted that it did not violate Title IX because the changes affected more men than women.	Affected_More_Men	EMU_compliant	
more men were effected because they are most likely sexist and had way more men teams than women teams.	Affected_More_Men	Miscellaneous	Limit_woms_opps
more men were affected from cutting men's wrestling, swimming and diving; since female atheletic opportunities were 15 years out of compliance, women still took a great hit.	Affected_More_Men	Limit_woms_opps	
a judge ruled that they had violated Title IX by doing so.	Court_Decision		
the court ruled they were violating Title IX.	Court_Decision		
the court ruled that Eastern Michigan had violated Title IX.	Court_Decision		
it was later ruled to be illegal under Title IX.	Court_Decision		
the court ruled it had violated Title IX.	Court_Decision		
it was illegal to due to according to the courts.	Court_Decision		
the court ruled that they had violated Title IX, that requires schools to give men and women equal chances to play sports, and would have to reinstate both.	Court_Decision	Judge_reinstate	
it was overturned by the court since they were in violation of Title IX.	Court_Decision	Judge_reinstate	
a judge ruled would have to reinstate the programs because they violated Title IX	Court_Decision	Judge_reinstate	
a judge ruled that it had to be brought back because it was not equal rights to women if they took it away.	Court_Decision	Judge_reinstate	
a court found that it exacerbated their existing failure to comply with Title IX’s requirement of equal funding for men and women’s sports programs and ruled that they had to restore those women’s teams.	Court_Decision	Judge_reinstate	
ended up being overruled by the court, who determined they had caused women to not have equal chances at sports.	Court_Decision	Judge_reinstate	
they were later reinstated when the school was ordered out of compliancd with Title IX by a judge.	Court_Decision	Teams_reinstated	
later had to reinstate both according to the judge's ruling on grounds of violation of Title IX.	Court_Decision	Teams_reinstated	
had to reinstate it after they were proven guilty for violating title IX.	Court_Decision	Teams_reinstated	
they were reinstated after a judge ruled the university was in violation of Title IX.	Court_Decision	Teams_reinstated	
they reinstated the two programs after a court of law found that the university had violated Title IX.	Court_Decision	Teams_reinstated	
they were later reinstated after a court case was brought for violating title IX.	Court_Decision	Teams_reinstated	
it was reinstated through Title IX	Court_Decision	Teams_reinstated	
the programs were later reinstated after a judge ruled the move had violated Title IX.	Court_Decision	Teams_reinstated	
the Judge ruled that it violated the title IX terms, so the sports where brought back.	Court_Decision	Teams_reinstated	
were forced to reinstate it by a judge due to Title IX	Court_Decision	Teams_reinstated	
this was later found to be illegal under Title IX.	Court_Decision		
court found that since the school had never fully coplied with Title IX that this constituted unequal treatment.	Court_Decision		
a judge ruled this was a violation of Title IX.	Court_Decision		
the court ruled that it's against title IX	Court_Decision		
it was ruled it should not have without considering the issues it would cause with Title IX compliance.	Court_Decision		
that decision was later ruled a violation of Title IX.	Court_Decision		
was ruled out of compliance with Title IX, because of the reduction of opportunities for women to be involved in athletics.	Court_Decision		
a court ruled that EMU's doing that violated Title IX.	Court_Decision		
the court ruled that Eastern Michigan had violated Title IX and had to reinstate women's tennis and softball.	Court_Decision	Judge_reinstate	
a judge ruled that the school would have to reinstate both programs due to Title IX violations.	Court_Decision	Judge_reinstate	
a judge ruled that they violated Title IX and they would need to reinstate both sports.	Court_Decision	Judge_reinstate	
a judge ruled that they must reinstate both of those sports or be in violation of Title IX.	Court_Decision	Judge_reinstate	
a judge ruled that the school had violated Title IX and the school would have to reinstate both women's softball and tennis.	Court_Decision	Judge_reinstate	
later added them back when it was found to be violating Title IX.	Court_Decision	Teams_reinstated	
were forced to reinstate it after the courts decison on Title IX.	Court_Decision	Teams_reinstated	
were forced to reinstate them after a court ruling found them guilty of breaching Article IX.	Court_Decision	Teams_reinstated	
they were later forced to reinstate them after a court found they violated Title 9.	Court_Decision	Teams_reinstated	
in the end they had to reinstate the teams due to a judges rule concerning title IX.	Court_Decision	Teams_reinstated	
had to reinstate it after the judge ruled it violated Title IX.	Court_Decision	Teams_reinstated	
it was later reinstated after the courts ruled against the university stating they were not in Compliance with Title 9.	Court_Decision	Teams_reinstated	
it was reinstated after the judge said they violated title nine.	Court_Decision	Teams_reinstated	
eventually reinstated both sports after they were found in violation of Title IX.	Court_Decision	Teams_reinstated	
reinstated the sports after it was determined that doing so violated Title IX.	Court_Decision	Teams_reinstated	
2 female student she the college for violating Title IX.	Women_sued		
that was challenged under Title IX.	Women_sued		
the two women filed a case title nine for no equal rights of both men and women.	Women_sued		
a female tennis player and a female softball player filed suit under Title IX.	Women_sued		
Chretien and Mayerova sued the University for violating Title IX.	Women_sued		
a couple student athletes claimed this wasn't fair.	Women_sued		
they got sued.	Women_sued		
Chretien and Mayerova sued the school.	Women_sued		
were latter sued for Title IX violations.	Women_sued		
they sued Eastern Michigan for violating Title IX.	Women_sued		
students claimed they had broken the law specifically tittle IX	Women_sued		
a few women athletes banded together to fight this decision.	Women_sued		
two students complained and sued	Women_sued		
the students sued the school.	Women_sued		
one of the Womens softball team members and one Womens Tennis team member fought this by claiming Title IX violation	Women_sued		
a student named Ariana decided to do something about it and fought the decision.	Women_sued		
Ariana Chretien thought the University was in violation of Title IX for cutting women's sports.	Women_sued		
some players refused to accept that and decided to sue the school.	Women_sued		
players were not happy and filed a case against the university, stating that they had violated Title IX.	Women_sued		
they were accused of violating title IX.	Women_sued		
Chretien refused to accept the school's decision to cut the teams; so she joined forces with Marie Mayerova, a tennis player and together they sued Eastern Michigan for violating Title IX.	Women_sued		
Ariana Chretien and Marie Mayerova sued the school, asserting that by cutting the programs, they were in violation of Title IX.	Women_sued		
chretein and Marie Mayerova, a tennis player sued Eastern Michigan for violating Title IX.	Women_sued		
Chretien and Mayerova claimed that Eastern Michigan broke the Title IX law.	Women_sued		
not comparable men's sports, which a pair of female athletes claimed was a violation of Title IX.	Women_sued		
a softball-playing student didn't accept it and, along with a tennis-playing student, sued.	Women_sued		
Ariana Chretien, a softball player, and Marie Mayerova, a tennis player, sued the school for violating Title IX.	Women_sued		
one of their female softball player s and a female tennis player sued the University for violating their rights under Title IX.	Women_sued		
two students argued that doing so violated Title IX.	Women_sued		
two prospective student sued with a title IX claim.	Women_sued		
two students contested that decision.	Women_sued		
two women went to court or argue otherwise.	Women_sued		
were sued by two women claiming the School had violated Title IX.	Women_sued		
a softball player and a tennis player sued the school to keep their sports alive.	Women_sued		
two students sued them, because they said that this was affecting women on sports.	Women_sued		
a lawsuit was filed claiming a violation of title IX	Women_sued		
two students later sued claiming the school was in violation of title nine.	Women_sued		
some students fought it in a legal battle.	Women_sued		
were sued by students to force them to continue the programs.	Women_sued		
a softball player wouldn't accept this outcome and she sued the college.	Women_sued		
students challenged this as a violation of Title IX.	Women_sued		
Chretien and Mayerova claimed that Eastern Michigan broke this Title IX and sued.	Women_sued		
this move was countered by a law suit from two female athletes that were affected by the cuts, citing Title IX violations.	Women_sued		
two students decided to sue the school.	Women_sued		
two female athlete were dissatisfied with the decision and file a lawsuit.	Women_sued		
paid the consequence when they were sued by two students.	Women_sued		
Chretien refused to accept the school's decision to cut the teams and sued the school.	Women_sued		
Chretien refused to accept the school's decision and sued Eastern Michigan for violating Title IX (pronounced “title nine”).	Women_sued		
Ariana Chretien refused to accept the decision and instead sued the university for violating Title IX.	Women_sued		
it didn't sit well with some students who decided to sue the school under Title XI.	Women_sued		
was sued due to the alleged violation of Title IX.	Women_sued		
was sued by two women.	Women_sued		
girl students sued the school for violating title nine.	Women_sued		
was sued for violating Title IX for doing so	Women_sued		
were sued by students claiming that the school was in violation of Title IX.	Women_sued		
was sued as a result.	Women_sued		
they were sued by two females that they were out of compliance with Title Nine with regards to gender equality in sports.	Women_sued		
were sued by two students for violating Title IX.	Women_sued		
were sued by a softball and tennis femenine players	Women_sued		
were sued for violating Title IX.	Women_sued		
were sued for violating title 9	Women_sued		
one of the women's softball and tennis players sued them for violating title IX.	Women_sued		
Chretien and Mayerova sued to reinstate the teams.	Women_sued		
two female students sued the university anyway.	Women_sued		
they were sued for allegedly violating Title IX.	Women_sued		
they were sued for violating title 9.	Women_sued		
several students sued them for violating Title IX.	Women_sued		
two students sued the school and claimed that the school violated a Title IX rule.	Women_sued		
were taking to court for violating Title IX.	Women_sued		
Chretien teamed up with Marie Mayorova in order to sue the school stating that they broke the law.	Women_sued		
this cut was determined to be illegal when two students sued via Title IX.	Women_sued	Court_Decision	
two female athletes sued and won the case because of Title IX.	Women_sued	Court_Decision	
after being sued for being in violation of Title IX and losing in court, the school was forced to reinstate both programs.	Women_sued	Court_Decision	
the programs were restored after the school was sued by two female athletes and the court ruled it had violated Title IX.	Women_sued	Court_Decision	
two student-athletes sued the school and the programs could not be cut, per a judge's ruling.	Women_sued	Judge_reinstate	
was ordered to reinstate them afteer being sued.	Women_sued	Judge_reinstate	
two women athletes sued that the school was violating Title IX, then It turned out, the school had been violating it for 15 years, so the judge ruled to reinstate sports so women will have as much chances to get into sports as men.	Women_sued	Judge_reinstate	
Ariana Chretien and Marie Mayerova reversed that by suing the school claiming they violated Title IX	Women_sued	Teams_reinstated	
those programs were then reinstated when female student athletes sued the school for violating Title IX	Women_sued	Teams_reinstated	
eventually reinstated the sports after being sued for violating Title XI.	Women_sued	Teams_reinstated	
were sued and had to reinstate both sports.	Women_sued	Teams_reinstated	
were sued by students and forced to reinstate the programs.	Women_sued	Teams_reinstated	
were sued over the decision and forced to reinstate.	Women_sued	Teams_reinstated	
2 female studens/players sued the school & won forcing the school into having the sports programs.	Women_sued	Teams_reinstated	
two players sued the school under Title IX causing the teams to be reinstated	Women_sued	Teams_reinstated	
a girl brought a title ix suit against them and the school was forced to reinstate the softball and tennis programs	Women_sued	Teams_reinstated	
a lawsuit brought by two female athletes led to these programs being reinstated.	Women_sued	Teams_reinstated	
due to a lawsuit by female athletes contesting that the move violated Title IX, the programs were reinstated.	Women_sued	Teams_reinstated	
a student filed a lawsuit against the school and the school had to re-instate women's tennis and softball.	Women_sued	Teams_reinstated	
but were eventually forced to reinstate them after being sued by a student.	Women_sued	Teams_reinstated	
was forced to reinstate them via lawsuit shortly afterwards.	Women_sued	Teams_reinstated	
was forced to reinstate funding due to a lawsuit citing Title IX.	Women_sued	Teams_reinstated	
were forced reinstate the teams because of a law case.	Women_sued	Teams_reinstated	
they were forced to reinstate these sports after being successfully sued for being in violation of Title IX.	Women_sued	Teams_reinstated	
athletes fought and won their case to have it reinstated.	Women_sued	Teams_reinstated	
later they had to open these sports because a potential student sued the University for violating Title IX.	Women_sued	Teams_reinstated	
had to re-instate both sports due to students suing in court.	Women_sued	Teams_reinstated	
had to reinstate them because two women athletes sued the university.	Women_sued	Teams_reinstated	
it had to reinstate both sports after two players sued the school.	Women_sued	Teams_reinstated	
had to reinstate them after losing a Title IX lawsuit.	Women_sued	Teams_reinstated	
they were later reinstated after two students sued the school for Title IX violations.	Women_sued	Teams_reinstated	
the programs were later reinstated when two female athletes sued the school for violating Title IX.	Women_sued	Teams_reinstated	
was reinstated after the university was sued by Chretien and Mayerova for violating Title IX.	Women_sued	Teams_reinstated	
two outstanding women sport enthusiasts sue they violated Title IX and had to reinstate their sports program for women.	Women_sued	Teams_reinstated	
they were later sued for it and they were reinstated.	Women_sued	Teams_reinstated	
Chretien and Mayerova sued them and won which caused EMU to reinstate women's tennis and softball.	Women_sued	Teams_reinstated	
a few players successfully sued the school for violating Title IX and reinstated both sports.	Women_sued	Teams_reinstated	
there were more teams that were affected by the cut, including two additional teams at the university.	Cuts_to_mens_sports		
other mens sports were also cut	Cuts_to_mens_sports		
also cut several men's sports programs.	Cuts_to_mens_sports		
also made cuts to the men's teams as well.	Cuts_to_mens_sports		
also cut several men's sports too.	Cuts_to_mens_sports		
also cut several of the men's teams.	Cuts_to_mens_sports		
also cut some mens teams.	Cuts_to_mens_sports		
men's sports were also cut.	Cuts_to_mens_sports		
also cut some men's sport programs as well.	Cuts_to_mens_sports		
they also cut mens sports.	Cuts_to_mens_sports		
also cut more men's sports teams as well.	Cuts_to_mens_sports		
it additionally cut a few men's sports also.	Cuts_to_mens_sports		
also cut two men's sports teams.	Cuts_to_mens_sports		
they also cut a great deal of sports positions for males.	Cuts_to_mens_sports		
also several men's sports.	Cuts_to_mens_sports		
they also cut some men's sports.	Cuts_to_mens_sports		
also cut several men's sports teams.	Cuts_to_mens_sports		
also cut some of the mens sports as well	Cuts_to_mens_sports		
two men's teams were also cut.	Cuts_to_mens_sports		
they also cut two men's teams	Cuts_to_mens_sports		
hey also cut some mens sports	Cuts_to_mens_sports		
also made cuts to men's sports.	Cuts_to_mens_sports		
it affected cuts to men's sports as well.	Cuts_to_mens_sports		
they also cut male sports as well.	Cuts_to_mens_sports		
also cut men's.	Cuts_to_mens_sports		
also cut some mens sports teams as well.	Cuts_to_mens_sports		
also cut other men's sports.	Cuts_to_mens_sports		
also cut men's programs.	Cuts_to_mens_sports		
also cut several men's sports.	Cuts_to_mens_sports		
the boys sports program was cut, also.	Cuts_to_mens_sports		
also cut certain sports for men.	Cuts_to_mens_sports		
they also cut several men's sports.	Cuts_to_mens_sports		
also cut three men's sports.	Cuts_to_mens_sports		
they also cut some men's programs as well	Cuts_to_mens_sports		
also cut two men's teams in different sports.	Cuts_to_mens_sports		
also cut three men's programs as well.	Cuts_to_mens_sports		
also cut men's sports.	Cuts_to_mens_sports		
they also cut some of the men sports too.	Cuts_to_mens_sports		
also cut multiple male programs.	Cuts_to_mens_sports		
they cut several mens's teams as well.	Cuts_to_mens_sports		
also cut some men's sports programs.	Cuts_to_mens_sports		
they also three male sports too.	Cuts_to_mens_sports		
also cut men's sports as well in an attempt to lower budget costs.	Cuts_to_mens_sports	Miscellaneous	
they've also cut men's sports, so Chretien and Mayerova need to take a chill pill.	Cuts_to_mens_sports	Miscellaneous	
It also cut men’s swimming and diving	Cuts_to_WSD,		
they also cut men's wrestling and swimming and diving.	Cuts_to_WSD,		
also cut mens wrestling, as well as mens swimming and diving.	Cuts_to_WSD,		
also cut the men's wrestling, swimming, and diving.	Cuts_to_WSD,		
also cut several men's sports like swimming and wrestling.	Cuts_to_WSD,		
they also cut men's wrestling and men's swimming.	Cuts_to_WSD,		
they also cut mens wrestling.	Cuts_to_WSD,		
cut the men's wrestling, men's swimming and diving teams as well.	Cuts_to_WSD,		
also cut the men's wrestling and men's swimming and diving teams.	Cuts_to_WSD,		
also cut men's swimming, diving and wrestling teams.	Cuts_to_WSD,		
also the mens wrestling and men and women's swimming and diving.	Cuts_to_WSD,		
it also eliminated men's wrestling, swimming and diving.	Cuts_to_WSD,		
also cut men's swimming, diving and wrestling.	Cuts_to_WSD,		
also cut men's swimming and diving.	Cuts_to_WSD,		
they also had cut the men's wrestling, along with men's swimming and diving clubs.	Cuts_to_WSD,		
also cut men's wrestling and swimming and diving.	Cuts_to_WSD,		
also cut men's wrestling, swimming, and diving as well.	Cuts_to_WSD,		
also cut mens' wrestling, swimming and diving.	Cuts_to_WSD,		
also cut men's wrestling and diving/swimming.	Cuts_to_WSD,		
also cut the men's wrestling and swimming and diving programs.	Cuts_to_WSD,		
also cut men's wrestling, swimming and diving	Cuts_to_WSD,		
men's swimming, wrestling, and diving was also cut.	Cuts_to_WSD,		
they also cut the men’s wrestling, swimming and diving teams.	Cuts_to_WSD,		
also cut men's teams as well such as wrestling, swimming and diving.	Cuts_to_WSD,		
they also cut men's wrestling, and men's swimming and diving.	Cuts_to_WSD,		
also cut men's wrestling, men's swimming and diving.	Cuts_to_WSD,		
cut men's swimming and diving as well.	Cuts_to_WSD,		
also cut men’s wrestling and men’s swimming and diving.	Cuts_to_WSD,		
also cut the men's wrestling, swimming and diving programs.	Cuts_to_WSD,		
also cut men's wrestling, swimming, and diving.	Cuts_to_WSD,		
also cut men's wrestling and diving.	Cuts_to_WSD,		
also men's swimming and diving.	Cuts_to_WSD,		
the university also cut many of the men's teams, such as swimming.	Cuts_to_WSD,		
also men's wrestling, swimming, and diving.	Cuts_to_WSD,		
also cut men’s wrestling, swimming, and diving	Cuts_to_WSD,		
they also cut men's wrestling, men's swimming and diving.	Cuts_to_WSD,		
also cut men’s wrestling, swimming, and diving.	Cuts_to_WSD,		
also cut men's wrestling, swimming, and diving in an effort to save money.	Cuts_to_WSD,		
the school also cut men's wrestling, men's swimming and diving, which affected more men than women.	Cuts_to_WSD,		
men's wrestling, men's swimming and diving, would not continue in the fall.	Cuts_to_WSD,		
they also cut men’s wrestling and men’s swimming and diving teams in an effort to treat both genders fairly.	Cuts_to_WSD,		
they also cut men's wrestling, swimming, and diving.	Cuts_to_WSD,		
they also cut men's wrestling and men's swimming and diving.	Cuts_to_WSD,		
they also cut men's wrestling, swimming and diving.	Cuts_to_WSD,		
also cut men's wrestling as well as swimming and diving.	Cuts_to_WSD,		
they also cut men's wrestling and swimming.	Cuts_to_WSD,		
they also cut men's swimming, diving, and wrestling programs.	Cuts_to_WSD,		
also cut men's wrestling, as well as men's swimming and diving.	Cuts_to_WSD,		
they also cut men's wrestling, men's swimming and diving at the same time.	Cuts_to_WSD,		
they also cut mens wrestling and swimming and diving.	Cuts_to_WSD,		
also cut men's sports team such as wrestling and swimming.	Cuts_to_WSD,		
also cut men's wrestling, diving, and swimming.	Cuts_to_WSD,		
also cut men's wrestling and men's swimming and diving.	Cuts_to_WSD,		
also cut the men's swimming, wrestling, and diving teams.	Cuts_to_WSD,		
also cut men's wrestling, swimming and diving.	Cuts_to_WSD,		
also cut men's wrestling, swimming, and diving programs.	Cuts_to_WSD,		
cut men's wrestling and swimming and diving as well.	Cuts_to_WSD,		
also cut men's wrestling and men's swimming to tray and make the cuts equal.	Cuts_to_WSD,		
also cut men's swimming wrestling and diving.	Cuts_to_WSD,		
also cut the men's wrestling team as well as their swim and diving team.	Cuts_to_WSD,		
they also cut men's wrestling and men's swimming and diving sports teams.	Cuts_to_WSD,		
also cut the mens swimming, diving, and wresting teams.	Cuts_to_WSD,		
the school also cut the men's wrestling, swimming and diving teams.	Cuts_to_WSD,		
men's wrestling, swimming and diving were cut as well.	Cuts_to_WSD,		
also cut the men's wrestling, swimming and diving teams as well.	Cuts_to_WSD,		
also cut the men's wrestling and the men's swimming and diving teams.	Cuts_to_WSD,		
also cut mens wrestling and swimming programs.	Cuts_to_WSD,		
it also cut men's wrestling, swimming and diving.	Cuts_to_WSD,		
also cut men's swimming and wrestling.	Cuts_to_WSD,		
also cut the men's wrestling, men's swimming and diving teams.	Cuts_to_WSD,		
also cut men's wresting and swimming and diving.	Cuts_to_WSD,		
also cut men's wrestling, swimming and diving as well.	Cuts_to_WSD,		
also cut the men's wrestling, men's swimming, and diving teams as well.	Cuts_to_WSD,		
it also cut men's wrestling, swimming, and diving.	Cuts_to_WSD,		
also cut the men's wrestling, men's swimming and diving.	Cuts_to_WSD,		
also cut men's swimming, diving, and wrestling.	Cuts_to_WSD,		
also cut men's sports including men's wrestling and swimming and diving.	Cuts_to_WSD,		
also cut mens wrestling and swimming	Cuts_to_WSD,		
they also cut the men's wrestling, men's swimming and diving.	Cuts_to_WSD,		
it also cut men's wrestling, men's swimming and diving.	Cuts_to_WSD,		
men wrestling and swimming will be cut too.	Cuts_to_WSD,		
also discontinued men's wrestling, swimming, and diving.	Cuts_to_WSD,		
also wrestling, swimming and men's diving teams	Cuts_to_WSD,		
also men's swimming, diving and wrestling.	Cuts_to_WSD,		
also men's swimming and wrestling.	Cuts_to_WSD,		
also men's wrestling, men's swimming and diving.	Cuts_to_WSD,		
also men's wrestling and swimming/diving.	Cuts_to_WSD,		
also men's wrestling, men's swimming and diving	Cuts_to_WSD,		
also the men's wrestling, swimming and diving teams.	Cuts_to_WSD,		
kept all the other sports except men's wrestling and swimming and diving.	Cuts_to_WSD,	Kept_other_ones	
also cut the men's wrestling, swimming and diving programs as well in an effort to save money.	Cuts_to_WSD,		
not other sports, including men's tennis.	Did_not_cut_t_and_s		
the men's tennis and softball teams were left untouched.	Did_not_cut_t_and_s		
not men’s.	Did_not_cut_t_and_s		
men's tennis and softball.	Did_not_cut_t_and_s		
they did not cut men's tennis or men's softball.	Did_not_cut_t_and_s		
they did not cut men's tennis or men's baseball.	Did_not_cut_t_and_s		
left men's tennis and softball.	Did_not_cut_t_and_s		
not men's softball and tennis.	Did_not_cut_t_and_s		
didn't cut the men's tennis and softball programs.	Did_not_cut_t_and_s		
did not cut men's tennis and men's softball.	Did_not_cut_t_and_s		
didn't cut men's tennis and softball.	Did_not_cut_t_and_s		
did not cut men's tennis or baseball.	Did_not_cut_t_and_s		
did not cut the same sports for men.	Did_not_cut_t_and_s		
didnt cut mens baseball	Did_not_cut_t_and_s		
men's tennis and softball were not cut.	Did_not_cut_t_and_s		
did not cut that of men.	Did_not_cut_t_and_s		
they did not cut the same sports for men.	Did_not_cut_t_and_s		
did not cut men's tennis and softball.	Did_not_cut_t_and_s		
didnt cut mens tennis or softball.	Did_not_cut_t_and_s		
they did keep men's tennis and baseball.	Did_not_cut_t_and_s		
kept the male’s tennis and softball teams.	Did_not_cut_t_and_s		
not men's tennis.	Did_not_cut_t_and_s		
not men’s tennis and softball.	Did_not_cut_t_and_s		
not the mens	Did_not_cut_t_and_s		
not the men's programs.	Did_not_cut_t_and_s		
not baseball	Did_not_cut_t_and_s		
not the mens tennis or baseball.	Did_not_cut_t_and_s		
not for the me's tennis or soft ball	Did_not_cut_t_and_s		
not the men's tennis and softball teams.	Did_not_cut_t_and_s		
they didn't evenly make the same changes to the men's programs violating Title IX.	Did_not_cut_t_and_s	EMU_viol_TitleIX	
they cut it at a major amount compared to mens sports.	EMU_cut_less_men		
some argued that more women's sports teams were cut than men's in violation of Title IX.	EMU_cut_less_men		
they allowed most of the men's teams to stay.	EMU_cut_less_men		
would continue other male sports.	EMU_cut_less_men		
did not cut many of the men's sports teams.	EMU_cut_less_men		
did not cut any of men's sports.	EMU_cut_less_men		
kept the men's sport	EMU_cut_less_men		
kept mens sports.	EMU_cut_less_men		
kept a good amount of men sports.	EMU_cut_less_men		
kept many of the men's programs.	EMU_cut_less_men		
kept the men's sports.	EMU_cut_less_men		
kept programs for men.	EMU_cut_less_men		
left the men’s teams alone.	EMU_cut_less_men		
made no cuts to men's sports.	EMU_cut_less_men		
made lesser cuts to men's sports programs.	EMU_cut_less_men		
not as many mens programs.	EMU_cut_less_men		
not any of the men's programs.	EMU_cut_less_men		
they did not cut men football or basketball.	Kept_other_ones		
continued other programs that were also open to women.	Kept_other_ones		
didn't cut other sports.	Kept_other_ones		
did not cut other women's sports at the school.	Kept_other_ones		
they did not cut football or basketball.	Kept_other_ones		
keep other sports programs.	Kept_other_ones		
kept other sports going.	Kept_other_ones		
kept other sports.	Kept_other_ones		
kept other sports such as men's football and basketball.	Kept_other_ones		
kept some mens sports.	Kept_other_ones		
kept some sport programs.	Kept_other_ones		
Kept the other sports programs, the most popular ones.	Kept_other_ones		
still kept a few athletic options.	Kept_other_ones		
were able to preserve funding for other sports.	Kept_other_ones		
other high-profile sports teams were spared the ax.	Kept_other_ones		
not all women's sports.	Kept_other_ones		
they will have other sports	Kept_other_ones		
insisted they didn't break any laws.	EMU_compliant		
they insisted they did not violate Title IX when they did so.	EMU_compliant		
denied that it violated Title IX.	EMU_compliant		
it claimed not to be in violation of Title IX.	EMU_compliant		
claimed this cut was only due to budget and did not violate Title IX.	EMU_compliant		
insists that it didn't violate Title IX.	EMU_compliant		
did not believe that they violated Title IX	EMU_compliant		
claimed they did not violate Title IX	EMU_compliant		
indicated that they did not violate title IX.	EMU_compliant		
insisted that it did not violate Title IX.	EMU_compliant		
Eastern Michigan insisted that it did not violate Title IX	EMU_compliant		
violated Title IX regulations.	EMU_viol_TitleIX		
it was found to be in violation of Title IX.	EMU_viol_TitleIX		
were still in violation of title of 9.	EMU_viol_TitleIX		
did violate Title IX	EMU_viol_TitleIX		
unknowingly violated Title IX in the process.	EMU_viol_TitleIX		
it was in violation of Title IX.	EMU_viol_TitleIX		
they violated Title XI in the process	EMU_viol_TitleIX		
were not in compliance with Title IX in doing so.	EMU_viol_TitleIX		
because they cut those sports for women they violated Title IX providing equal representation for women and men in sports.	EMU_viol_TitleIX		
violated title IX in the process.	EMU_viol_TitleIX		
this decision was in violation of Title IX.	EMU_viol_TitleIX		
violated Title IX	EMU_viol_TitleIX		
they did not fully take into account Title IX rules.	EMU_viol_TitleIX		
Eastern Michigan had violated Title IX	EMU_viol_TitleIX		
the cuts violated Title IX.	EMU_viol_TitleIX		
did not give consideration to Title IX which stipulates that schools give equal chances to both men and women to play sports, which in effect broke the law.	EMU_viol_TitleIX		
it was in violation of Title IX which was used to promote gender fairness in education.	EMU_viol_TitleIX		
that violated a law.	EMU_viol_TitleIX		
they were already in violation of the law before making the cuts.	EMU_viol_TitleIX		
was later found to be in violation of Title IX.	EMU_viol_TitleIX		
violated the law in doing so.	EMU_viol_TitleIX		
broke a law	EMU_viol_TitleIX		
this caused a potential violation of Title IX by denying women access to certain sporting activities.	EMU_viol_TitleIX		
in doing so, they violated Title IX.	EMU_viol_TitleIX		
in doing so it may have violated Title IX.	EMU_viol_TitleIX		
by doing so brought attention to the fact that they were not compliant with title IX	EMU_viol_TitleIX		
failed to comply with regulations put forth by Title IX.	EMU_viol_TitleIX		
this put the school out of compliance with Title IX for fifteen years.	EMU_viol_TitleIX		
that was shown to be in violation of title IX.	EMU_viol_TitleIX		
in effort to do so they violate Title IX.	EMU_viol_TitleIX		
they violate title IX	EMU_viol_TitleIX		
violated title IX rules by doing so.	EMU_viol_TitleIX		
it violated title nine	EMU_viol_TitleIX		
they violated Title IX.	EMU_viol_TitleIX		
Eastern Michigan still violated Title IX.	EMU_viol_TitleIX		
still violated Title IX.	EMU_viol_TitleIX		
violated Title IX.	EMU_viol_TitleIX		
this violated Title X.	EMU_viol_TitleIX		
that was in violation of Title IX.	EMU_viol_TitleIX		
in an effort to save money, the school reduced its sports programs.	Miscellaneous		
it was an effort to save the school money.	Miscellaneous		
it saves money for the University.	Miscellaneous		
they had budget issues.	Miscellaneous		
some women student athletes refused to accept this solution to the school's financial troubles.	Miscellaneous	Fem_athletes_mad	
one of the players on the team did not take the news very well and took further action against the termination of the softball program.	Fem_athletes_mad		
some potential students fought back over unfairness and violation of Title IX.	Fem_athletes_mad		
a student and softball player affected by the decision refused to accept it.	Fem_athletes_mad		
this angered several of the school's female athletes.	Fem_athletes_mad		
two women believed that it violated gender equality laws and attempted to reinstate women's tennis and softball.	Fem_athletes_mad		
some tennis players came together to not let it happen.	Fem_athletes_mad		
two students claimed that Eastern Michigan University broke the law by violating Title IX.	Fem_athletes_mad		
students disagree	Fem_athletes_mad		
some female athletes felt this was a violation of Title 1X.	Fem_athletes_mad		
women fought back against the discrimination.	Fem_athletes_mad		
When softball player Ariana Chretien heard the news, she grew worried nd She joined forces with Marie Mayerova, a tennis player Chretien and Mayerova claimed that Eastern Michigan broke this law	Fem_athletes_mad		
Ariana Chretien was determined to keep the programs.	Fem_athletes_mad		
Chretien refused to accept that and joined forces with Marie Mayerova.	Fem_athletes_mad		
one person refused to accept the decision	Fem_athletes_mad		
one softball player refused to accept the decision.	Fem_athletes_mad		
a student would not stand for the cut	Fem_athletes_mad		
Ariana Chretien and Marie Mayerova teamed up to fight the decision to cut the sports.	Fem_athletes_mad		
players were not happy with this decision.	Fem_athletes_mad		
two female student's claimed this violated Title IX, and got the sports reinstated.	Fem_athletes_mad	Teams_reinstated	
two players from the sports joined forces and made the school reinstate them.	Fem_athletes_mad	Teams_reinstated	
two female athletes teamed up to fight this decision and the programs were eventually reinstated.	Fem_athletes_mad	Teams_reinstated	
the court intervened	Judge_reinstate		
were ordered by a judge to reinstate them after being found guilty of violating Title IX.	Judge_reinstate		
after being sued by two female students claiming the school was in violation of Title IX, a judge overturned this decision.	Judge_reinstate		
the judge for this case ruled that these sports would be reinstated.	Judge_reinstate		
a judge ruled that the school should reinstate both women's softball and tennis.	Judge_reinstate		
they were ordered to reinstate them	Judge_reinstate		
a judge ruled that they both be reinstated.	Judge_reinstate		
a judge ordered them to reinstate these sports.	Judge_reinstate		
were court order to reinstate the prpgrams	Judge_reinstate		
the judge ruled that the school would have to reinstate both women's softball and tennis.	Judge_reinstate		
a judge ruled that the school must reinstate both sports programs.	Judge_reinstate		
a judge ruled that they would have to reinstate it.	Judge_reinstate		
the judge ruled that the school would have to reinstate them both.	Judge_reinstate		
a judge ruled they would have to reinstate them both.	Judge_reinstate		
a judge ruled that the school would have to reinstate both women's softball and tennis	Judge_reinstate		
were later required by a judge to reinstate both sports.	Judge_reinstate		
were issued to reinstate women's tennis and softball after being ruled by a judge.	Judge_reinstate		
a judge ordered that they would have to reinstate them.	Judge_reinstate		
will have to reinstate them after the court rulings.	Judge_reinstate		
the judge rule it to be reinstated	Judge_reinstate		
the courts ruled against them doing so.	Judge_reinstate		
a judge ruled that they would have to reinstate women's tennis and softball.	Judge_reinstate		
a judge ruled that both programs would have to be reinstated.	Judge_reinstate		
a judge ruled that the institution had to reinstate those programs.	Judge_reinstate		
the court ruled that both programs should be reinstated.	Judge_reinstate		
court ruled against it	Judge_reinstate		
a judge ruled that they would have to reinstate the sports.	Judge_reinstate		
a judge ruled that both sports should be reinstated	Judge_reinstate		
the judge ruled the school has to reinstate both tennis and softball.	Judge_reinstate		
a judge ruled to reinstate both teams under Title IX.	Judge_reinstate		
a judge ruled the school would have to reinstate both due to title IX violation.	Judge_reinstate		
it had cut more than 2 men's sports programs.	Miscellaneous		
cut more men's sports program.	Miscellaneous		
did not understand how this would affect women's sports and Title IX.	Miscellaneous		
this was a negative move considering that it would disproportionately affect women's already limited access to sports at the university.	Miscellaneous		
reduced female access to sports.	Miscellaneous		
kept other women's sports teams.	Miscellaneous		
by law they have to give all students a chance at an education.	Miscellaneous		
perhaps they needed to save money	Miscellaneous		
Chretien was unhappy due to Eastern Michigan being the only school that had previously offered a softball and aviation program.	Miscellaneous		
left other women's sports.	Miscellaneous		
didn't cut as many men's programs.	Miscellaneous		
they work hard on the game.	Miscellaneous		
would continue in the fall.	Miscellaneous		
it will limit women chances to play more	Miscellaneous		
it was able to save money.	Miscellaneous		
this seemed to affect women athletes unfairly at that school.	Miscellaneous		
the chance affect equally genders	Miscellaneous		
no major.	Miscellaneous		
Although Chretien had received multiple softball scholarship offers, Eastern Michigan was the only school that also offered an aviation major.	Miscellaneous		
it was because they did not have the budget to continue the sports in the fall.	Miscellaneous		
not the men's teams.	Miscellaneous		
good	Miscellaneous		
it was unfair because there were only a small percentage of woman playing sports.	Miscellaneous		
did not think about how it would impact women in sports.	Miscellaneous		
I find a school with aviation but no scholarships or scholarships but no major."	Miscellaneous		
would not continue in the fall.	Miscellaneous		
did not cut all of the men's sports only some of them in order to meet it's expenses.	Miscellaneous		
When softball player Ariana Chretien heard the news, she grew worried .The cuts meant that Chretien would have to choose between two of her passions--softball and aviation	Miscellaneous		
no other women's teams	Miscellaneous		
The men's wrestling, men's swimming and diving, women's tennis, and women's softball teams would not continue in the	Miscellaneous		
didn't anticipate the impact their decision would have on female athletes in particular.	Miscellaneous		
not any mens programs.	Miscellaneous		
did not cut spending on other athletic sports such as men's football or men's and women's basketball.	Miscellaneous		
she refused	Miscellaneous		
left some men's programs untouched.	Miscellaneous		
would have to choose between two of her passions--softball and aviation.	Miscellaneous		
any task in the sports.	Miscellaneous		
offered aviation.	Miscellaneous		
they made the cuts equally across the board between mens and womens programs.	Miscellaneous		
Ariana Chretien would have to choose between softball and aviation, her desired major.	Miscellaneous		
kept aviation major.	Miscellaneous		
emphasized education.	Miscellaneous		
ok lmao reminds me of my messages and cheese sticks out	Miscellaneous		
not all sports.	Miscellaneous		
forgot about Title 1X which Chretien and Marie took advantage of.	Miscellaneous		
cuts meant Chretien would have to choose between her two passions, one being aviation.	Miscellaneous		
that won't be enough they will need to cut other programs too.	Miscellaneous		
the determination of Ariana Chretien to keep these programs allowed them to stay.	Miscellaneous		
kept other programs	Miscellaneous		
removing women's opportunities in sports violated Title IX , which was put in place to ensure gender fairness in education.	Miscellaneous		
it was a necessary choice given their lack of budget money.	Miscellaneous		
this affected the women's teams more.	Miscellaneous		
not the aviation program.	Miscellaneous		
the cut showed that the schools didn't give enough attention to female sports.	Miscellaneous		
they still have the drive to keep going.	Miscellaneous		
kept many other clubs and sports including men even the non popular ones.	Miscellaneous		
did not cut some other sports.	Miscellaneous		
students and members university did not agree with the decision.	Miscellaneous		
not many of the other men's teams.	Miscellaneous		
Chretien refused to accept the school's decision to cut the teams.	Miscellaneous		
me	Miscellaneous		
athletes fought back.	Miscellaneous		
nice	Miscellaneous		
this is illegal according to Title IX.	Miscellaneous		
they added more funding to football and golf.	Miscellaneous		
Ariana Chretien had to choose between her passion of Aviation and playing softball.	Miscellaneous		
they did not consider whether this violated Title IX.	Miscellaneous		
did not fully consider the Title IX ruling implications.	Miscellaneous		
women's softball teams would not continue in the fall.	Miscellaneous		
would not continue in fall.	Miscellaneous		
continued to fund other men's sports that contributed to their unequal athletics program.	Miscellaneous		
many other sports teams were cut as well.	Miscellaneous		
they did not cut the aviation program.	Miscellaneous		
they should have just cut men's programs to balance the situation.	Miscellaneous		
students felt it unfairly reduced women's chances of sport scholarships.	Miscellaneous		
not the scholarships that had gone with it.	Miscellaneous		
increased the presence of women's now	Miscellaneous		
mans's percentage increased and their in popular	Miscellaneous		
they are looking for new game.	Miscellaneous		
the cuts made the situation worse.	Miscellaneous		
that made Ariana Chretien as due to this she will now be forced to choose one of two passion.	Miscellaneous		
made their situation worse.	Miscellaneous		
did not offer a reason for these two sports in particular.	Miscellaneous		
still offered an aviation major.	Miscellaneous		
they offered aviation classes which most schools did not do.	Miscellaneous		
offers tennis	Miscellaneous		
they do not play the game well	Miscellaneous		
They still play	Miscellaneous		
did realize the backlash it would have.	Miscellaneous		
did not realize the effect this would have on their female athletes.	Miscellaneous		
did not realize their would be lash back from the women athletes.	Miscellaneous		
didn't realize there would be harsh repercussions by doing so	Miscellaneous		
requires schools to give men and women equal chances to play sports.	Miscellaneous		
the government requires colleges to give women an equal chance to participate in athletics.	Miscellaneous		
will revisit the decision	Miscellaneous		
Feb 12, 2019 - A judge ruled Tuesday that Eastern Michigan must hire a softball coach	Miscellaneous		
In court filing, Eastern Michigan University says a federal judge shouldn't be ... that Eastern restart women's tennis and softball programs	Miscellaneous		
Nothing else, from what i can see.	Miscellaneous		
some universities still struggle to fulfill this obligation	Miscellaneous		
supports by parents.	Miscellaneous		
did not take into account the gab in numbers of already limited female sports players.	Miscellaneous		
v	Miscellaneous		
there is aviation major	Miscellaneous		
not aviation.	Miscellaneous		
some problems.	Miscellaneous		
very good	Miscellaneous		
AND GIRLS	Miscellaneous		
the situation was even worse.	Miscellaneous		
no scholarship or scholarship but no major	Miscellaneous		
other universities did not.	Miscellaneous		
no scholarships or scholarships but no major	Miscellaneous		
kept some of the more popular and profitable sports.	Miscellaneous	Kept_other_ones	
kept other programs available because they didnt want to cut out everything	Miscellaneous	Kept_other_ones	
it still violated title 9 rule and its seem more favorable for the men	Miscellaneous	EMU_viol_TitleIX	
should not have, given that it was already in violation of Title IX.	Miscellaneous	EMU_viol_TitleIX	
the teams were eventually reinstated because the university did not have enough female sports.	Miscellaneous	Teams_reinstated	
had to reinstate the teams due to Title IX.	Teams_reinstated		
were legally obligated to reinstate them.	Teams_reinstated		
they were later forced to reinstate them.	Teams_reinstated		
they had to reinstate it for violating Title IX.	Teams_reinstated		
had to reinstate the sports due to a court ruling regarding Title IX.	Teams_reinstated		
were reinstated after courts decided the the university violated Title IX by making those cuts.	Teams_reinstated		
they eventually had to be reinstated due to a lawsuit.	Teams_reinstated		
they were reinstated.	Teams_reinstated		
they later had to reinstate them after the court forced them to.	Teams_reinstated		
was forced to reinstate the programs by the court.	Teams_reinstated		
they had to later reinstate the program.	Teams_reinstated		
they will be back	Teams_reinstated		
reinstated them after being told to by a judge.	Teams_reinstated		
they had to reverse their decision and reinstate them.	Teams_reinstated		
ultimately reinstated both.	Teams_reinstated		
they had to reinstate it due to a court ruling.	Teams_reinstated		
these were reinstated after a judge's ruling.	Teams_reinstated		
it was one of only a few options for woman to play in sports so was later reinstated.	Teams_reinstated		
was forced to reinstate the activity.	Teams_reinstated		
restatedf it after lawsuite	Teams_reinstated		
ended up having to reinstate both.	Teams_reinstated		
the University had to reinstate both women's softball and tennis.	Teams_reinstated		
ended up having to reinstate them.	Teams_reinstated		
they had to bring it back	Teams_reinstated		
they ended up reinstating them down the road.	Teams_reinstated		
ended up reinstating it.	Teams_reinstated		
was forced to reinstate them	Teams_reinstated		
later were forced to reinstate them.	Teams_reinstated		
a court ruling forced them to reinstate them.	Teams_reinstated		
were eventually forced to reinstate them.	Teams_reinstated		
was eventually forced to reverse its decision.	Teams_reinstated		
they were forced to reinstate it by a judge.	Teams_reinstated		
was forced by court order to reinstate them.	Teams_reinstated		
was later forced to reinstate them.	Teams_reinstated		
they were later forced to reinstate them after a court decision.	Teams_reinstated		
were forced to reinstate them after losing a court case.	Teams_reinstated		
the court forced them to reinstate both women's softball and tennis.	Teams_reinstated		
was forced by judicial order to reinstate both programs.	Teams_reinstated		
had to reinstate both according to the court ruling.	Teams_reinstated		
had to reinstate the programs.	Teams_reinstated		
had to reinstate it both teams.	Teams_reinstated		
had to later reinstate them after the court's decision	Teams_reinstated		
the school would have to reinstate both women's softball and tennis.	Teams_reinstated		
they reinstated both.	Teams_reinstated		
later reinstated those teams due to a court decision.	Teams_reinstated		
Title IX reinstated those sports.	Teams_reinstated		
after reinstated them.	Teams_reinstated		
these programs were reinstated.	Teams_reinstated		
later reinstated them after a judge ruled that they must do so.	Teams_reinstated		
reinstated after the courts required them to.	Teams_reinstated		
the court required the school to reinstate both teams.	Teams_reinstated		
were forced to reinstate both sports in order to be in compliance with Title IX	Teams_reinstated	EMU_viol_TitleIX	
they ended up reinstating the sports because they were out of compliance with Title IX.	Teams_reinstated	EMU_viol_TitleIX	
later had to reinstate both sports because they had violated Title IX.	Teams_reinstated	EMU_viol_TitleIX	
had to re-instate them after violating Title IX.	Teams_reinstated	EMU_viol_TitleIX	
had to bring it back because they were in violation of Title IX	Teams_reinstated	EMU_viol_TitleIX	
since the school was out of compliance, they were forced to offer the sports again because they were not offering women enough opportunities to play sports.	Teams_reinstated	EMU_viol_TitleIX	
eventually had to reinstate them because it violate Title IX	Teams_reinstated	EMU_viol_TitleIX	
had to reinstate the teams because they violated Title IX.	Teams_reinstated	EMU_viol_TitleIX	
had to reinstate them because they violated title IX by making these cuts.	Teams_reinstated	EMU_viol_TitleIX	
eventually had to reverse the decision due to Title IX violations.	Teams_reinstated	EMU_viol_TitleIX	
it failed to realize that it made the situation worse for women when it comes to complying with Title IX.	Limit_woms_opps		
it affected women's fairness to equally play sports.	Limit_woms_opps		
that was not fair for women's because they all ready argued that women were already underrepresented in the school's sports teams while about 60% of the student population was female, less than 45% of the school's athletes were women the cuts, they said, would	Limit_woms_opps		
cutting the sports reduced the number of woman playing.	Limit_woms_opps		
that would limit women's chances to play sports even more than it already had been.	Limit_woms_opps		
that significantly reduced women's access to sports	Limit_woms_opps		
the cuts showed that the school was not making enough effort to give women equal access to sports.	Limit_woms_opps		
women are already underrepresented at the school, so they would stand to lose more.	Limit_woms_opps		
this further limited female students' access to sports.	Limit_woms_opps		
women were already underrepresented in the school's sports teams.	Limit_woms_opps		
they were already in violation of Title IX for at least 15 years before this, therefore this only contributed more to the inequality involving school sports.	Limit_woms_opps	EMU_viol_TitleIX	
neglected to take into consideration the fact that their was less choices for women as a consequence, which violated the law.	Limit_woms_opps	EMU_viol_TitleIX	
it only made an existing problem worse since they were already out of compliance with Title IX.	Limit_woms_opps	EMU_viol_TitleIX	
they were already out of compliance with Title IX regulations and made the problem even worse by cutting women's teams.	Limit_woms_opps	EMU_viol_TitleIX	
they were reinstated because the school saw a major decline in equality among genders.	Limit_woms_opps	Teams_reinstated

