female players took the school to court to protect gender quality.	Ath_claim_TitleIX		
2 women filed a suit that accused the school of violating the federal government's Title IX which promotes gender equality in sports.	Ath_claim_TitleIX		
Chretien and Mayerova , two female student athletes affected by the cuts, sued Eastern Michigan for violating Title IX .	Ath_claim_TitleIX		
Chretien and Mayerova claimed a law was broken.	Ath_claim_TitleIX		
Chretien and Mayerova claimed that Eastern Michigan broke this law.	Ath_claim_TitleIX		
Chretien and Mayerova claimed that Eastern Michigan broke Title IX and fought to get this fixed.	Ath_claim_TitleIX		
Chretien and Mayerova claimed that Eastern Michigan broke Title IX.	Ath_claim_TitleIX		
Chretien believed they violated Title IX.	Ath_claim_TitleIX		
one of the women players who needed the sports for her scholarship took action and enforced title IX	Ath_claim_TitleIX	Miscellaneous	
some students sued Eastern Michigan for violating Title IX	Ath_claim_TitleIX		
some women challenged the school by invoking title 9.	Ath_claim_TitleIX		
student's held the school accountable for Title IX.	Ath_claim_TitleIX		
students fought the decision and sought to reverse same via Title 9.	Ath_claim_TitleIX		
the student did not want to believe what was happening so she found out that the school was violating title IX.	Ath_claim_TitleIX		
the students argued wemon were underrepresented and the school broke tittle IX	Ath_claim_TitleIX		
two athletes claimed that the university had broken the law.	Ath_claim_TitleIX		
two potential students joined forces to fight the supposed violation of Title IX.	Ath_claim_TitleIX		
two students claimed that the school was violating title nine.	Ath_claim_TitleIX		
two students took a case to court claiming they were in violation of Tile 1X.	Ath_claim_TitleIX		
two students, Chretien and Mayerova, claimed that Eastern Michigan broke the Title IX law.	Ath_claim_TitleIX		
two women claimed the university violated Title IX.	Ath_claim_TitleIX		
women claimed they violated Title IX.	Ath_claim_TitleIX		
their decision was challenged by two athletes.	Ath_fought		
a female softball player complained about the cuts.	Ath_fought		
a player on the softball team fought to save them.	Ath_fought		
a softball player and a tennis played joined forces to save their teams.	Ath_fought		
a student fought back and saved the teams for everyone.	Ath_fought	Teams_got_reinstated	
a student on a softball scolarship expressed concern for the decision.	Ath_fought		
a women’s tennis player and a women’s softball player joined together to fight this decision.	Ath_fought		
Chreitin fought back	Ath_fought		
female athletes banded together to fight for equal opportunities to play sports at Eastern Michigan.	Ath_fought		
participants on the teams grew frustrated and took action to reinstate the sports	Ath_fought		
people rallied to make sure the change would be reversed, quoting Title IX as a reason to keep the sports	Ath_fought		
several female students banded together to prevent this from happening.	Ath_fought		
some athletes got together and challenged the decision.	Ath_fought		
some female students rallied together to challenge the university's decision.	Ath_fought		
students in those athletics for scholarships were forced to make a move to save their teams.	Ath_fought		
they refused to accept the decision	Ath_fought		
two female athletes took matters into their own hands to get the programs up and running again.	Ath_fought		
two students rallied against the school since this is illegal.	Ath_fought		
two women set out to get them reinstated.	Ath_fought		
when softball player Ariana Chretien heard the news she knew something had to be done.	Ath_fought		
women athletes fought back.	Ath_fought		
women stood up to change it.	Ath_fought		
2 female atheletes sued the school to say their rights were being violated, a judge agreed.	Ath_sued	Court_EMU_viol	
2 female students sued the college to have the teams reinstated.	Ath_sued		
a couple female athletes sued them.	Ath_sued		
a student sued them to get softball reinstated.	Ath_sued		
after the school was sued the judge made it that the school had to reinstate both male and female softball and tennis programs.	Ath_sued	Judge_said_reinstate	
Chretien and Mayerova sued Eastern Michigan University and won.	Ath_sued		
there were students who took action and formed a lawsuit against the university.	Ath_sued		
they were taken to court by female athletes saying they violated the law.	Ath_sued		
Title IX stepped in after Ariana sued the school and made them continue the programs.	Ath_sued	Teams_got_reinstated	
Ariana Chretien and Marie Mayerova sued them.	Ath_sued		
Ariana Chretien and Marie Mayerova suied the school.	Ath_sued		
Chretien and Mayerova sued and won against the school.	Ath_sued		
Chretien sued them.	Ath_sued		
softball player Ariana Chretien and tennis player Marie Mayerova sued Eastern Michigan.	Ath_sued		
the two women sued them.	Ath_sued		
they were sued	Ath_sued		
they were sued by Ariana Chretien and she won the case.	Ath_sued		
they were sued by Chretien and Mayerova.	Ath_sued		
they were sued by female athletes.	Ath_sued		
they were sued by the women affected.	Ath_sued		
they were sued by two women who would have seen their respective sports eliminated.	Ath_sued		
two students sued the university because they wanted to be able to play tennis and retain a scholarship.	Ath_sued	Miscellaneous	
two women went to court to argue otherwise and in the end the women won.	Ath_sued		
a couple of their students ended up suing them.	Ath_sued		
a couple of women athletes considering the school sued the school.	Ath_sued		
a court case was filed by two female athletes and the university lost.	Ath_sued		
a female student athlete joined a force to sue the university.	Ath_sued		
a female student sued the school.	Ath_sued		
a few players decided to retaliate and fight the school on the decision by sueing them.	Ath_sued		
a few players decides to sue the school in an effort to get both sports reinstated.	Ath_sued		
a lawsuit ensued and it was ruled that they had to reinstate both.	Ath_sued	Teams_got_reinstated	
a member from each team came together to sue the school to get the sports reinstated.	Ath_sued		
a prospective sued and won so they had to be reinstated	Ath_sued	Teams_got_reinstated	
a softball and tennis played jointly sued the University.	Ath_sued		
a student softball player and a pro tennis player sued the school.	Ath_sued		
a young player sued the school to get it resumed.	Ath_sued		
a young woman decided to stand up for women everywhere and sued the university for violating Title IX.	Ath_sued	Miscellaneous	
an angry woman sued the university.	Ath_sued		
an incoming student sued the school.	Ath_sued		
Anna Chretien and Marie Mayerova sued the school.	Ath_sued		
Ariana Chretien and another female tennis player sued the school.	Ath_sued		
Ariana Chretien and Marie Mayerova joined hands to sue the university.	Ath_sued		
Ariana Chretien and Marie Mayerova sued the school.	Ath_sued		
Ariana Chretien sued Eastern Michigan Univeristy.	Ath_sued		
Ariana Chretien sued the school.	Ath_sued		
Ariana Chretien sued them with the help of another student.	Ath_sued		
Ariana Chretien took them to court.	Ath_sued		
Chretien and Mayerova decided to team up and challenge Eastern Michigan's decision.	Ath_sued		
Chretien and Mayerova filed a lawsuit.	Ath_sued		
Chretien and Mayerova joined forces together to sue the school in an effort to reverse this decision.	Ath_sued		
Chretien and Meyerova sued the university.	Ath_sued		
Chretien decided to join forces and sue them.	Ath_sued		
female athletes sued in order to still participate in sports and the educational benefits.	Ath_sued		
it could help deal with financial troubles, though they got sued by two students.	Ath_sued	Reduce_costs	
litigation was initiated in order to have those programs reinstated.	Ath_sued		
now they faced a lawsuit which caused them to reinstate the programs.	Ath_sued	Teams_got_reinstated	
one of the students who was a softball player sued the school and got the school to reinstate softball and tennis.	Ath_sued	Teams_got_reinstated	
one softball player decided to sue the university.	Ath_sued		
several students sued the school and won.	Ath_sued		
some of the university students got upset and sued the school.	Ath_sued		
some scholastic student players filed a lawsuits demanding their teams remain unaffected.	Ath_sued		
student Ariana Chretien sued so she could attend its aviation program and receive a sports scholarship at the school.	Ath_sued	Miscellaneous	
students affected by this change protested, and ultimately won over the university.	Ath_sued	Teams_got_reinstated	
students challenged the decision in Court.	Ath_sued	Miscellaneous	
students felt compelled to sue them	Ath_sued		
students sued the school.	Ath_sued		
the court was then involved to deem the reduction in female sports against Title IX.	Ath_sued		
the girl athletes who lost their sport take the matter to court.	Ath_sued		
the girls of the teams somehow managed to get a judge to rule that the school was out of line, and the female clubs were reinstated.	Ath_sued	Teams_got_reinstated	
the girls sued the college in court to reinstate the sports programs.	Ath_sued		
the students took them to court.	Ath_sued		
the team members had sued the school.	Ath_sued		
they ended up being sued and losing in Federal Court and reinstating the women's softball and tennis programs.	Ath_sued	Teams_got_reinstated	
they ended up suing them.	Ath_sued		
they filed a lawsuit against the school	Ath_sued		
they got sued for violating Title IX.	Ath_sued		
they sued and a judge ruled that the school would have to reinstate both women's softball and tennis	Ath_sued	Judge_said_reinstate	
they were charged to court	Ath_sued		
they were sued by a softball and women's tennis player.	Ath_sued		
they were sued by a student.	Ath_sued		
they were sued by students affected by the cuts.	Ath_sued		
they were sued.	Ath_sued		
two female athletes sued the school.	Ath_sued		
two female athletes sued the University in order to get the sports teams reinstated.	Ath_sued		
two female students successfully argued the cuts.	Ath_sued		
two female students sued the university.	Ath_sued		
two female students sued.	Ath_sued		
two of the female athletes sued to get the sports reinstated.	Ath_sued		
two of the school's female athletes got together and sued the school.	Ath_sued		
two of the women affected decided to sue the university to reinstate the programs.	Ath_sued		
two players decided to sue them to get the sports back	Ath_sued		
two students decided to sue the school because they thought it was unfair to themselves, regardless of what was best for the school.	Ath_sued	Miscellaneous	
two students decided to sue the school.	Ath_sued		
two women at the college did something about it by suing and having the two sports reinstated.	Ath_sued		
two women challenged that decision and took them to court.	Ath_sued		
two women sued the school.	Ath_sued		
two women sued the university for discrimination.	Ath_sued		
two women sued the university.	Ath_sued		
two women sued them	Ath_sued		
with the careful work of one student softball player, the court system ended up making the University reinstate the women's tennis and softball teams.	Ath_sued	Teams_got_reinstated	
women athletes sued the school.	Ath_sued		
a student sued them for violating Title IX laws and won the lawsuit.	Ath_sued_TitleIX	Court_EMU_viol	
Ariana and Marie sue the title IX	Ath_sued_TitleIX		
certain students have sued the school alleging women's teams were cut unfairly in proportion to cuts to men's teams.	Ath_sued_TitleIX		
they were sued by Ariana Chretien for violations of Title IX.	Ath_sued_TitleIX		
Ariana Chretien and Marie Mayerova sued Eastern Michigan for violating women the right to have equal opportunity to play sports, also known as Title IX.	Ath_sued_TitleIX		
Ariana Chretien and Marie Mayerova sued the school for violating Title IX.	Ath_sued_TitleIX		
Ariana Chretien and Marie Mayerova sued the school, because they felt the cut would unfairly affect women in spots and thus be in violation o Title IX.	Ath_sued_TitleIX		
Ariana Chretien and Marie Mayerova sued them for violating Title IX.	Ath_sued_TitleIX		
Ariana Chretien sued the school for violating Title IX.	Ath_sued_TitleIX		
Chretien and Mayerova sued Eastern Michigan for violating Title IX .	Ath_sued_TitleIX		
Chretien and Mayerova sued the school for violating title IX, thus breaking the law.	Ath_sued_TitleIX		
Chretien and Mayerova sued them for violating Title IX.	Ath_sued_TitleIX		
Chretien sued to have the program reinstated under title IX.	Ath_sued_TitleIX		
Chretien took the case to court saying it was violating women's rights.	Ath_sued_TitleIX		
the two female athletes, Ariana Chretien and Marie Mayerova sued the school for Title IX violations, saying that the cuts would limit women's chances to play sports.	Ath_sued_TitleIX		
the two women in the story teamed up and sued the university for violating Title IX	Ath_sued_TitleIX		
the two women took them to court for violating Title IX.	Ath_sued_TitleIX		
they had to face two female student-athletes in court about Title IX.	Ath_sued_TitleIX		
they were sued and the courts ruled that they had been in violation of Title IX for quite some time and this latest decision made their case worse.	Ath_sued_TitleIX	Court_EMU_viol	Made_viol_worse
they were sued by a student who alleged discrimination.	Ath_sued_TitleIX		
they were sued by some of the athletes impacted by the decision and ultimately lost the case due to their long history of non-compliance with regulations.	Ath_sued_TitleIX	Court_EMU_viol	
they were sued by two female athletes for violating Title IX.	Ath_sued_TitleIX		
they were sued on Title IX grounds by softball athlete Ariana Chretien.	Ath_sued_TitleIX		
they were taken to court and forced to reinstate both teams in order to maintain compliance with title IX.	Ath_sued_TitleIX	Teams_got_reinstated	
two female athletes sued and won a law suit against the university for violating Title IX.	Ath_sued_TitleIX		
two female athletes sued the university for violating Title IX.	Ath_sued_TitleIX		
two students sued the school citing the school had violated Title IX.	Ath_sued_TitleIX		
two students sued the school for violating Title IX.	Ath_sued_TitleIX		
two students sued the university for gender inequality in sports.	Ath_sued_TitleIX		
women students sued them for Title IX violation.	Ath_sued_TitleIX		
2 student-athletes decided it didn't follow Title Nine so they sued the university.	Ath_sued_TitleIX		
a couple female athletes sued them over Title IX non-compliance.	Ath_sued_TitleIX		
a couple of students sued Eastern Michigan for violating Title IX.	Ath_sued_TitleIX		
a female athlete student sued the school for violating an act that provides women equal opportunities at school.	Ath_sued_TitleIX		
a female athlete took the university to court for violating Title IX.	Ath_sued_TitleIX		
a female softball player and tennis player sued for Title IX violations.	Ath_sued_TitleIX		
a female tennis player and a female softball player sued the school claiming that the cuts to the school's sports program violated Title IX.	Ath_sued_TitleIX		
a member of the women's tennis and a member of the women's softball team challenged the legality of cutting the programs.	Ath_sued_TitleIX		
a prospective student sued the school for violating Title IX.	Ath_sued_TitleIX		
a softball player and a tennis player sued the school for violation of title IX.	Ath_sued_TitleIX		
a student athlete who had a softball scholarship teamed up with someone to sue the university for violating Title IX.	Ath_sued_TitleIX		
a student sued and claimed they violated Title IX.	Ath_sued_TitleIX		
a student who wanted to study aviation, one of their programs, and also have a sports grant, sued the University saying that they were discriminating against women sports.	Ath_sued_TitleIX		
a suit was brought against them and the court ruled that Eastern Michigan had violated Title IX.	Ath_sued_TitleIX	Court_EMU_viol	
a Title IX case was brought against them.	Ath_sued_TitleIX		
an athlete put together a lawsuit claiming they were committing a Title IX violation.	Ath_sued_TitleIX		
Arian Chretian and Marie Mayerova teamed up to report their school for violating Title IX laws.	Ath_sued_TitleIX		
Ariana Chertien--a softball player--and Marie Mayerova--a tennis player--sued the school for violating Title IX.	Ath_sued_TitleIX		
Ariana Chretein sued the university for violating Ttitle IX.	Ath_sued_TitleIX		
Ariana Chretian and Marie Mayerova sued the university for violating Title IX.	Ath_sued_TitleIX		
Ariana Chretien and Maria Mayerova sued Eastern Michigan for violating Title IX, a law that mandates schools to give men & women an equal chance in sports.	Ath_sued_TitleIX		
Ariana Chretien and Marie Mayerova decided to sue them for violating Title IX.	Ath_sued_TitleIX		
Ariana Chretien and Marie Mayerova refused to accept the school's decision to cut the teams, they sued Eastern Michigan for violating Title IX.	Ath_sued_TitleIX		
Ariana Chretien and Marie Mayerova sued Eastern Michigan for violating Title IX.	Ath_sued_TitleIX		
Ariana Chretien and Marie Mayerova sued the school and ultimately won the lawsuit, because the courts ruled that the school had violated Title IX when they made the cuts.	Ath_sued_TitleIX		
Ariana Chretien and Marie Mayerova sued the school for violating title nine.	Ath_sued_TitleIX		
Ariana Chretien and Marie Mayerova sued the university for violation of Title IX.	Ath_sued_TitleIX		
Ariana Chretien and Marie Mayerova sued the University to get it to comply with Title IX.	Ath_sued_TitleIX		
Ariana Chretien joined forces with a woman from the tennis team and they went to court, claiming that the university violated Title IX.	Ath_sued_TitleIX		
Ariana Chretien joined forces with Marie Mayerova and sued them for violating Title XI.	Ath_sued_TitleIX		
Ariana Chretien joined forces with Marie Mayerova and together, they sued Eastern Michigan for violating Title IX (pronounced “title nine”).	Ath_sued_TitleIX		
Ariana Chretien joined forces with Marie Mayerova to sue Eastern Michigan for violating Title IX.	Ath_sued_TitleIX		
Ariana Chretien joined forces with Marie Mayerova to sue the school for violating Title IX.	Ath_sued_TitleIX		
Ariana Chretien joined with a fellow female athelete in suing the school for gender inequality in regards to their school sports.	Ath_sued_TitleIX		
Ariana Chretien sued the school for being involution of Title IX.	Ath_sued_TitleIX		
Ariana Chretien sued them for violating Title IX	Ath_sued_TitleIX		
Ariana Chretien, along with Marie Mayerova sued the university for being in violation of Title IX, which led to the programs being reinstated but kept the financial state of the University in question.	Ath_sued_TitleIX	Teams_got_reinstated	Miscellaneous
Ariana sued for violation of Title IX	Ath_sued_TitleIX		
as retaliation the students of Eastern Michigan University decided to sue the school for violation of Title IXs policy, and as a result of the case going into the students favor, both women's tennis and softball were reinstated	Ath_sued_TitleIX	Teams_got_reinstated	
athletes Ariana Chretien and Marie Mayerova filed a lawsuit against the school arguing that they had violated title IX.	Ath_sued_TitleIX		
certain students went to court because they believed this was a title IX violation.	Ath_sued_TitleIX		
Chretien and Marie Mayerova, a tennis player, sued Eastern Michigan for violating Title IX (pronounced “title nine”).	Ath_sued_TitleIX		
Chretien and Mayerova sued the school for under-representation of women's athletics.	Ath_sued_TitleIX		
Chretien and Mayerova sued the University for violating Title IX.	Ath_sued_TitleIX		
Chretien and Mayerova sued the university in attempt to save women's tennis and softball.	Ath_sued_TitleIX		
Chretien and Mayerova sued them citing that they were violating Title IX	Ath_sued_TitleIX		
Chretien and Mayerova took them to court for violating Title IX.	Ath_sued_TitleIX		
Chretien joined forces with Marie Mayerova, a tennis player and sued Eastern Michigan for violating Title IX.	Ath_sued_TitleIX		
Chretien sued Eastern Michigan for violating Title IX.	Ath_sued_TitleIX		
eventually Ariana and Marie Mayerova, a tennis player, sued Eastern MIchigan for violating Title IX.	Ath_sued_TitleIX		
female athletes Chretien and Mayerova sued the school that it violated Title IX which promoted gender equality in education.	Ath_sued_TitleIX		
female athletes from the school sued for breach of Title IX.	Ath_sued_TitleIX		
female athletes joined together to take the school to court for sex-discrimination among sports funding.	Ath_sued_TitleIX		
female athletes sued Eastern Michigan University for violating Title IX.	Ath_sued_TitleIX		
female student-athletes Ariana Chretien and Marie Mayerova sued the school for violating Title IX.	Ath_sued_TitleIX		
female students sued the school, claiming that it was in violation of Title IX.	Ath_sued_TitleIX		
it was sued for violating title IX	Ath_sued_TitleIX		
it was sued for violating Title IX.	Ath_sued_TitleIX		
now the University finds itself being sued for violating Title IX.	Ath_sued_TitleIX		
players took matters into their own hands by suing the school for violation of the title 9 act.	Ath_sued_TitleIX		
She joined forces with Marie Mayerova, a tennis player.Together, they sued Eastern Michigan for violating Title IX (pronounced “title nine”).	Ath_sued_TitleIX		
softball player Ariana Chretien and a tennis player sued the university for violation of Title IX.	Ath_sued_TitleIX		
softball player Ariana Chretien and Marie Mayerova, a tennis player, joined together to sue Eastern Michigan for violating Title IX.	Ath_sued_TitleIX		
softball player Ariana Chretien and tennis player Marie Mayerova sued the school for violating Title IX.	Ath_sued_TitleIX		
softball player Ariana Chretien and tennis player Marie Mayerova sued the university for violating Title IX.	Ath_sued_TitleIX		
softball player Ariana Chretien and tennis player Marie Mayerova, sued Eastern Michigan for violating Title IX.	Ath_sued_TitleIX		
softball player Ariana Chretien joined forces with Marie Mayerova, a tennis player to sue the college for women's equality in sports programs.	Ath_sued_TitleIX		
softball player Ariana Chretien sued the school for violating Title 9.	Ath_sued_TitleIX		
softball player Ariana Chretien, a softball player and Marie Mayerova, a tennis player, sued the school for violating Title IX.	Ath_sued_TitleIX		
softball players joined forces with tennis player and sued the school for violating Title 9.	Ath_sued_TitleIX		
some student sued the school, claiming that they violated Title IX when they did so.	Ath_sued_TitleIX		
some students protested the change by suing the school for violating Title IX.	Ath_sued_TitleIX		
students Chretien from the softball team, and Mayerova, from the tennis team, refused to accept the decision and sued the university for violating Title IX.	Ath_sued_TitleIX		
students sued the school stating it violated Title IX.	Ath_sued_TitleIX		
students sued them for not being compliant with Title IX.	Ath_sued_TitleIX		
the school was forced to contend with a law suit alleging violations of Title IX and ultimately had to reinstate the programs.	Ath_sued_TitleIX	Teams_got_reinstated	
the school was taken to court over Title IX violations.	Ath_sued_TitleIX	Teams_got_reinstated	
they could save money, but they were sued for violating Title IX.	Ath_sued_TitleIX	Reduce_costs	
they ended up being sued by female students because of Title IX.	Ath_sued_TitleIX		
they ended up having to reinstate them because of Title IX.	Ath_sued_TitleIX	Teams_got_reinstated	
they ended up in a legal battle that ended up making them bring back the teams.	Ath_sued_TitleIX	Teams_got_reinstated	
they ended up in litigation regarding noncompliance with Title IX which resulted in them reinstating both women's teams.	Ath_sued_TitleIX	Teams_got_reinstated	
they faced a legal challenge over Title IX.	Ath_sued_TitleIX		
they got sued by students	Ath_sued_TitleIX		
they got sued due to a Title IX breach	Ath_sued_TitleIX		
they got sued for violating Title IX and lost.	Ath_sued_TitleIX		
they got sued.	Ath_sued_TitleIX		
they had a Title IX complaint filed against them.	Ath_sued_TitleIX		
they sued Eastern Michigan for violating Title IX	Ath_sued_TitleIX		
they sued Eastern Michigan for violating Title IX (pronounced “title nine”).	Ath_sued_TitleIX		
they were sued due to Title IX concerns about female students' access to sports.	Ath_sued_TitleIX		
they were sued for noncompliance with Title IX.	Ath_sued_TitleIX		
they were sued for Title IX violations.	Ath_sued_TitleIX		
they were sued for violating Title IX	Ath_sued_TitleIX		
they were sued for violating Title IX and required to reinstate the two affected sports programs.	Ath_sued_TitleIX	Teams_got_reinstated	
they were sued for violating Title IX which requires schools to provide equal opportunity to play sports to men and women.	Ath_sued_TitleIX		
they were sued for violating title IX.	Ath_sued_TitleIX		
they were sued for violating title nine which promotes general fairness in education.	Ath_sued_TitleIX		
they were sued for violation of title IX.	Ath_sued_TitleIX		
they were sued under Title IX.	Ath_sued_TitleIX		
they were taken to court over title IX and lost so had to reinstate both.	Ath_sued_TitleIX	Teams_got_reinstated	
this decision ultimately backfired when two students brought suit again the University for violating their rights.	Ath_sued_TitleIX		
this led to two students suing EMU for violation of Title IX	Ath_sued_TitleIX		
Together, they sued Eastern Michigan for violating Title IX (pronounced “title nine”)	Ath_sued_TitleIX		
two athletes filed suit saying the university violated Title IX laws.	Ath_sued_TitleIX		
two athletes from these teams joined together to fight the decision and appeal that they had violated Title IX by doing so.	Ath_sued_TitleIX		
two athletes sued the college to claim they were in violation of Title IX.	Ath_sued_TitleIX		
two athletes sued them for violating Title IX.	Ath_sued_TitleIX		
two female athlete's who were affected by this sued the college for Title IX violations.	Ath_sued_TitleIX		
two female athletes affected by the cuts - Ariana Chretien and Marie Mayerova - successfully sued them to restore their teams because the court’s found that the cuts violated Title IX.	Ath_sued_TitleIX	Teams_got_reinstated	
two female athletes chose to sue the University for violating Title IX.	Ath_sued_TitleIX		
two female athletes claimed the school violated Title IX and the issue was taken to court.	Ath_sued_TitleIX		
two female athletes decided to sue the school, claiming that the University had violated Title XI.	Ath_sued_TitleIX		
two female athletes from each sport decided to sue the university for violating Title IX.	Ath_sued_TitleIX		
two female athletes sued the school for violating Title IX.	Ath_sued_TitleIX		
two female athletes sued the university because it was violating Title IX.	Ath_sued_TitleIX		
two female athletes sued them for allegedly violating Title IX.	Ath_sued_TitleIX		
two female athletes sued them for violating Title IX.	Ath_sued_TitleIX		
two female athletes teamed up to fight this decision by arguing that it violated Title IX.	Ath_sued_TitleIX		
two female athletes took it upon themselves to bring a lawsuit against the school claiming these actions violated title IX.	Ath_sued_TitleIX		
two female college students, one a softball player and one a tennis player, sued the school for violating Title IX.	Ath_sued_TitleIX		
two female student athletes decided to sue them for gender discrimination.	Ath_sued_TitleIX		
two female student athletes sued the school claiming the school was violating Title IX requirements.	Ath_sued_TitleIX		
two female students sued them for violating Title IX.	Ath_sued_TitleIX		
two female students sued them for violation of Title IX	Ath_sued_TitleIX		
two female students sued to get the sports reinstated based on Title IX.	Ath_sued_TitleIX		
two female students took them to court for Title IX violations.	Ath_sued_TitleIX		
two female students, a tennis player and softball player, sued the university for violating Title 9.	Ath_sued_TitleIX		
two girls brought a title ix suit against the school	Ath_sued_TitleIX		
two of the affected women sued under Title IX.	Ath_sued_TitleIX		
two of the athletes from those teams sued the school for a Title IX violation.	Ath_sued_TitleIX		
two of the players decided to sue them for breaking Title IX.	Ath_sued_TitleIX		
two of the school's female athletes decided to challenge the decision, citing Title IX.	Ath_sued_TitleIX		
two players sued due to Title IX violation	Ath_sued_TitleIX		
two prospective students sued the university for violating Title IX .	Ath_sued_TitleIX		
two student athletes decided to sue the university for violations to Title IX.	Ath_sued_TitleIX		
two students decided to start a case claiming Title IX in order to keep their scholarships.	Ath_sued_TitleIX	Miscellaneous	
two students decided to sue the school for unfairness in school sports	Ath_sued_TitleIX		
two students decided to sue the university for its violation of Title IX.	Ath_sued_TitleIX		
two students filed a lawsuit stating they school was violating Title IX.	Ath_sued_TitleIX		
two students joined together to sue Eastern Michigan for violating Title IX.	Ath_sued_TitleIX		
two students paired together to sue the university against a title IX lawsuit.	Ath_sued_TitleIX		
two students rallied and sued the school for violation of Title IX.	Ath_sued_TitleIX		
two students sued the university, citing TITLE IX violations, and won their case, reinstating the programs.	Ath_sued_TitleIX	Teams_got_reinstated	
two women student athletes sued the school for violating Title IX.	Ath_sued_TitleIX		
two women sued the school for violating title IX.	Ath_sued_TitleIX		
two women sued the school stating they were in violation of Title IX.	Ath_sued_TitleIX		
two women sued them for violation of Title XI.	Ath_sued_TitleIX		
two women who were affected by the cuts sued the school claiming that the school was violating Title IX, the law designed to promote gender fairness in education and sports programs in colleges.	Ath_sued_TitleIX		
Arian Chretien had to chose between not having a scholarship or not having a major.	C_had_to_choose		
Ariana Chretien had to choose between her major of Aviation and pursing the sport.	C_had_to_choose		
Ariana Chretien had to choose between sports or scholarships.	C_had_to_choose		
Ariana Chretien had to choose if she still wished to attend.	C_had_to_choose		
Ariana Chretien was either faced with choosing between two of her passions: Aviation and softball.	C_had_to_choose		
Ariana Chretien worried that she would have to find another school to attend but she could not find one that offered both her major, aviation and softball scholarships.	C_had_to_choose		
Ariana Chretien would have to choose between her major and her athletic scholarship.	C_had_to_choose		
Ariana Chretien would have to choose between two of her passions--softball and aviation.	C_had_to_choose		
Ariana Chretien would have to pick between her two passions - softball and aviation.	C_had_to_choose		
Ariana Chretien would not be able to get her scholarship while also pursuing her aviation major.	C_had_to_choose		
Ariana Chretien wouldn't have a scholarship and she wouldn't be about to persue her aviation major.	C_had_to_choose		
Ariana Chretien, would have to choose between softball and avaiation.	C_had_to_choose		
certain individuals were forced to choose between scholarships and playing sports.	C_had_to_choose		
certain students were faced with the choice of no scholarships or scholarships but no major.	C_had_to_choose		
Chretien had to choose between softball and aviation.	C_had_to_choose		
Chretien had to make a difficult decision on whether to pursue softball elsewhere, or attend EMU for aviation but risk not receiving a scholarship.	C_had_to_choose		
Chretien would have to choose between two of her passions--softball and aviation.	C_had_to_choose		
Chretien would have to choose between two of her passions.	C_had_to_choose		
either I find a school with aviation but no scholarships or scholarships but no major."	C_had_to_choose		
incoming student Ariana Chetrien felt she had no other choice than to take legal action due to her dependence on a softball scholarship EMU offered and her major in aviation, which EMU was one of a few schools offering that with	C_had_to_choose	Ath_sued	
softball player Ariana Chretien would have to choose between two of her passions; softball and aviation.	C_had_to_choose		
some female athletes had to choose between receiving scholarship funds at other schools or staying at Eastern Michigan and continuing their major field of study but with no scholarship funds.	C_had_to_choose		
the woman who was majoring in aviation had to chose between no scholarship and to continue at EMU, or to go to another college that did not have an aviation program.	C_had_to_choose		
the young woman in question was left with fewer options, aviation as a major, but no sports scholarship because softball would be cut and she was receiving sports scholarships.	C_had_to_choose		
this meant that Chretien would have to choose between two of her passions--softball and aviation.	C_had_to_choose		
a judge ruled that they did in fact break the law, and ordering Eastern Michigan University to reinstate the programs.	Court_EMU_viol	Judge_said_reinstate	
they broke Title IX law.	Court_EMU_viol		
The court ruled that EMU was not making a sufficient effort to provide women with equal sports opportunities in compliance with Title IX.	Court_EMU_viol		
the court ruled that the University had violated Section IX.	Court_EMU_viol		
the University did violate Title IX.	Court_EMU_viol		
they had violated Title IX.	Court_EMU_viol		
they violated section 9.	Court_EMU_viol		
they violated some portion of Title IX by cutting an already underserved woman's athletic teams.	Court_EMU_viol	Made_viol_worse	
they violated title 9	Court_EMU_viol		
they violated title IX	Court_EMU_viol		
violated Title IX.	Court_EMU_viol		
a judge ordered them to comply with Title IX because they were not giving men and women equal opportunity in their school.	Court_EMU_viol		
it appeared they were violating Title IX.	Court_EMU_viol		
it broke the law of title IX.	Court_EMU_viol		
it ended up with a court ruling against it that noted it had already been violating Title IX for over 15 years.	Court_EMU_viol		
it violated title 9.	Court_EMU_viol		
it violated Title IX, a judge ruled.	Court_EMU_viol		
it violated Title IX, the Judge ruled.	Court_EMU_viol		
it violated Title IX.	Court_EMU_viol		
the court ruled that Eastern Michigan had violated Title IX	Court_EMU_viol		
the court ruled that Eastern Michigan had violated Title IX and was out of compliance for at least 15 years.	Court_EMU_viol		
the court ruled that Eastern Michigan had violated Title IX.	Court_EMU_viol		
the court ruled that the school had violated Title IX.	Court_EMU_viol		
the court ruled that they violated Title IX.	Court_EMU_viol		
the courts ruled EMU violated Title IX for being out of compliance for the last 15 years.	Court_EMU_viol		
the courts ruled they were out of compliance with Title IX.	Court_EMU_viol		
the judge ruled that they were in violation of Title IV by having women underrepresented at their school in sports.	Court_EMU_viol		
the university violated Title IX.	Court_EMU_viol		
they broke the Title IX law.	Court_EMU_viol		
they violated Title IX and were held responsible for their lack of fairness in womens representation of sports at the school	Court_EMU_viol		
they violated Title IX.	Court_EMU_viol		
they were found in violation of Title IX when brought to court over the cuts to womens sports	Court_EMU_viol		
they were found in violation of Title IX.	Court_EMU_viol		
they were found to be in violation of title IX and accused of sexism.	Court_EMU_viol	Miscellaneous	
they were found to have violated title IX.	Court_EMU_viol		
a judge reversed their decision and the programs are in effect still.	Judge_said_reinstate	Teams_got_reinstated	
the judge ruled that the school would have to reinstate both women's softball and tennis.	Judge_said_reinstate		
a judge ruled that the school would have to reinstate the sports.	Judge_said_reinstate		
As a result, the judge ruled that the school would have to reinstate both women's softball and tennis.	Judge_said_reinstate		
the judged ruled that the school would have to reinstate both programs.	Judge_said_reinstate		
they were technically wrong as a judge ruled in court that they would have to revert change.	Judge_said_reinstate		
women participating in those sports programs were unable to pursue their passions.	Limit_to_fem_opps		
25 women lost access to the sport they had been playing.	Limit_to_fem_opps		
25 women lost their athletic opportunities. 	Limit_to_fem_opps		
even though it limited women's chances to play sports it did save the University some money.	Limit_to_fem_opps	Reduce_costs	
female students felt they were not receiving equal opportunities to pursue sports.	Limit_to_fem_opps		
female students were now underrepresented in sports teams.	Limit_to_fem_opps		
fewer women had access to sports.	Limit_to_fem_opps		
it would limit women's chance to play sports	Limit_to_fem_opps		
less women have the opportunity to play sports at the school.	Limit_to_fem_opps		
nearly 25 women would lose scholarships.	Limit_to_fem_opps		
the cuts reduced Eastern Michigan's sports programs by 25 women and 58 men.	Limit_to_fem_opps		
the women felt they were under represented within the school athletics program.	Limit_to_fem_opps		
there were fewer sports for women to play.	Limit_to_fem_opps		
they could manage to a budget and therefore a court ruled that by doing this it disproportionately impacted female athletes and the court ruled to have those programs/sports reinstated.	Limit_to_fem_opps	Judge_said_reinstate	Reduce_costs
they would limit women's chances to play sports.	Limit_to_fem_opps		
women were even more underrepresented in university athletics than they had been before.	Limit_to_fem_opps		
women were not being given equal access to sports in the school.	Limit_to_fem_opps		
women's access to sports was limited.	Limit_to_fem_opps		
women's chances of playing sports were reduced.	Limit_to_fem_opps		
women's chances to play sports at that school were limited even more.	Limit_to_fem_opps		
women's chances to play sports were limited.	Limit_to_fem_opps		
the judge emphasized that the cuts to the women’s teams made the situation even worse.	Made_viol_worse		
the judge ruled to reinstate it as it made the situation worse.	Made_viol_worse	Judge_said_reinstate	
they were further in violation of Title IX.	Made_viol_worse		
a judge ruled they had actually made the situation worse.	Made_viol_worse		
even less women were given access to sports at the university.	Made_viol_worse		
female college students were even more underrepresented in sports at this school as a result.	Made_viol_worse		
He explained that the cuts showed that the school was not making enough effort to give women equal access to sports.	Made_viol_worse		
it reduced women's chances to play sports even more.	Made_viol_worse		
it was further in violation of Title IX.	Made_viol_worse		
it was ruled that the school made the Title IX situation even worse.	Made_viol_worse		
now woman athletes at the school have even less opportunity to play sports.	Made_viol_worse		
so.it would limit women's chances to play sports even more	Made_viol_worse		
The cuts, they said, would limit women's chances to play sports even more.	Made_viol_worse		
the school was not making enough effort to give women equal access to sports	Made_viol_worse		
the underrepresented female athletes were reduced by an even greater number.	Made_viol_worse		
there was even less chances for women to play sports.	Made_viol_worse		
the could ballence their budget they provided a bad services and for the the last 15 years they pick on cutting the womans sports	"Made_viol_worse	
"	Reduce_costs	
it affected scholarships.	Miscellaneous		
they could stay out of trouble.	Miscellaneous		
they ran afoul of Title IX	Miscellaneous		
women cannot practice sports.	Miscellaneous		
Ariana Chretien would lose her scholarship or be required to change to a school that didn't support her major in Avaition.	Miscellaneous		
there was an uproar	Miscellaneous		
they tried to follow the law.	Miscellaneous		
v	Miscellaneous		
very good	Miscellaneous		
very interested the sports students.	Miscellaneous		
A judge ruled Tuesday that Eastern Michigan must hire a softball	Miscellaneous		
A judge ruled Tuesday that Eastern Michigan must hire a softball A judge ruled Tuesday that Eastern Michigan	Miscellaneous		
Ariana Chretien and Marie Mayerova decided to accuse the school of sexism as a way of saving only the women's teams.	Miscellaneous		
Ariana Chretien faced a difficult decision.	Miscellaneous		
Ariana Chretien lost her scholarship to the aviation school of her choice.	Miscellaneous		
Chretcien had to choose if she still wanted to attend.	Miscellaneous		
Chretien was upset because she had a softball scholarship.	Miscellaneous		
enough money was available for other programs.	Miscellaneous		
female students with tennis or softball scholarships would no longer receive those funds.	Miscellaneous		
first of all woman is lower then the boys	Miscellaneous		
for not good	Miscellaneous		
Grove City College created a path to sanity.	Miscellaneous		
happy.	Miscellaneous		
I'm going to make it more	Miscellaneous		
In college athletics programs, Title IX requires schools to give men and women equal chances to play sports	Miscellaneous		
IS VERY GOOD	Miscellaneous		
it put a lot of strain on women who were there for those scholarship programs.	Miscellaneous		
it was done	Miscellaneous		
It was the only school that also offered a specialization in aviation	Miscellaneous		
it was trying to make enough effort to be inclusive	Miscellaneous		
made smaller amount of students	Miscellaneous		
many female players were upset.	Miscellaneous		
many students will lose there scholarships	Miscellaneous		
me	Miscellaneous		
more	Miscellaneous		
more money can be allocated to academic programs.	Miscellaneous		
much is a chicken and I don't trust people easily	Miscellaneous		
multiple student athletes had to juggle the decision of major vs scholarship.	Miscellaneous		
nothing.	Miscellaneous		
now they are trying to work hard on the nest game.	Miscellaneous		
now they need to work hard on the next game.	Miscellaneous		
other sports can still play.	Miscellaneous		
other things could be afforded	Miscellaneous		
others will suffer in the future	Miscellaneous		
people are upset	Miscellaneous		
people got angry that they were prejudice against women.	Miscellaneous		
people sued because that's what we do in this generation.	Miscellaneous		
people were upset about losing women's athletics.	Miscellaneous		
scholarships attached to those sports would be lost.	Miscellaneous		
something needs to be done to hold colleges to the law of offering these programs.	Miscellaneous		
that men can retain their tennis and softball.	Miscellaneous		
that the budget would help pay for the education of the student and not on games in a place where learning is priority over playing games	Miscellaneous		
that the university could continue to stay be in business.	Miscellaneous		
That there was enough funding to cover the other sports programs.	Miscellaneous		
that they could balance their budget.	Miscellaneous		
that they could prioritize other parts of the schools curriculum.	Miscellaneous		
that women who had scholarships in those sports had their scholarships in jeopardy.	Miscellaneous		
the athletes felt upset about losing their sports.	Miscellaneous		
the girl who wanted to major in aviation but also had a softball scholarship felt cheated.	Miscellaneous		
the other sports could continue at the school.	Miscellaneous		
the players had to forcefully chose between what sport they want to be part of.	Miscellaneous		
the scholarship programs for female athletes in those sports were doomed unless the recipients could force the university to reinstate those programs by suing them for Title IX violations.	Miscellaneous		
The school argued that the changes affected more men than women.	Miscellaneous		
the students could have the correct amount of funding dedicated to their academic pursuits.	Miscellaneous		
the students had to either chose a different sport or not play at all.	Miscellaneous		
their budget would be less than originally projected.	Miscellaneous		
they are being unfair to women in sports.	Miscellaneous		
they can most likely use the money for their best men teams.	Miscellaneous		
they could clear room for more Male sports.	Miscellaneous		
they could get under budget.	Miscellaneous		
they could pay 4.5 million for their budget.	Miscellaneous		
they cut men's wrestling.	Miscellaneous		
They got fined for violating Title IX.	Miscellaneous		
they were worried	Miscellaneous		
they will focus on other sports	Miscellaneous		
they would have enough money for football.	Miscellaneous		
they would have less to finance for the athletic program.	Miscellaneous		
they would not be fined	Miscellaneous		
they would not comply to the new law of gender equality.	Miscellaneous		
those programs were not longer available to women participating in them causing problems for women with a scholarship in these programs.	Miscellaneous		
those women had some tough decisions to make.	Miscellaneous		
Title IX was put in place in order to ensure fairness across genders with regards to collegiate sports.	Miscellaneous		
was perceived as being unfair to the women athletes who needed these teams to remain in place for scholarship reasons.	Miscellaneous		
well	Miscellaneous		
were decided to have violated gender equality.	Miscellaneous		
will play the sports.	Miscellaneous		
woeks chances to play sports were limited even more.	Miscellaneous		
woman can play softball and tennis	Miscellaneous		
woman who received scholarships lost those chances leaving them in a less privileged standing as male students.	Miscellaneous		
women are not able to play sports and get an education as easily as they should.	Miscellaneous		
women who received scholarships for tennis and softball had effectively lost their scholarships.	Miscellaneous		
that they could save money.	Reduce_costs		
that they could trim expenses from the budget.	Reduce_costs		
that they could trim the budget	Reduce_costs		
they could reduce the over spending without cutting more male sports teams.	Reduce_costs	Miscellaneous	
they could spend less on supporting sports teams to decrease their financial deficit.	Reduce_costs		
it could save money in the long run through canceling certain activities that was using too much money.	Reduce_costs	Miscellaneous	
it could save money to keep other programs funded	Reduce_costs	Miscellaneous	
that they could recover from financial decline.	Reduce_costs		
that they could use the money spent on those activities for other reasons.	Reduce_costs		
there will be more money available for other better things.	Reduce_costs	Miscellaneous	
they could get out of the financial troubles the were in.	Reduce_costs		
they could meet budget guidelines.	Reduce_costs		
they could reduce expenses.	Reduce_costs		
they could save funding and put elsewhere	Reduce_costs		
they could save money to help with their current financial crisis the college was experiencing.	Reduce_costs		
they thought they were saving money and helping the budget.	Reduce_costs		
to be better able to get within budget monies.	Reduce_costs		
to save money.	Reduce_costs		
an effort to save money, the school reduced its sports programs.	Reduce_costs		
as to balance a budget they didn't have money to fund.	Reduce_costs		
as to come out of financial trouble	Reduce_costs		
as to come under budget, they cannot afford to go over	Reduce_costs		
as to save money	Reduce_costs		
as to save money.	Reduce_costs		
In an order for an effort to save money,	Reduce_costs		
it could attempt to correct budgetary shortfalls.	Reduce_costs		
it could balance its budget.	Reduce_costs		
it could better meet budget.	Reduce_costs		
it could bring its budget back into balance.	Reduce_costs		
it could continue on with its remaining sports and programs on a tight budget.	Reduce_costs		
it could cut spending.	Reduce_costs		
it could reduce its budget.	Reduce_costs		
it could save money b	Reduce_costs		
it could save money from being over budget.	Reduce_costs		
it could save money to meet its budget	Reduce_costs		
it could save money.	Reduce_costs		
it could stay out of financial trouble.	Reduce_costs		
it could stay within its budget allowance.	Reduce_costs		
it seemed that this decision would save money by reducing some sports programs	Reduce_costs		
it would be able to reduce it's deficit spending	Reduce_costs		
it would be able to stay within budget for the 2018 year.	Reduce_costs		
it would reduce the amount of monies being spent on sports.	Reduce_costs		
lots of money was saved.	Reduce_costs		
money could be saved.	Reduce_costs		
money could be utilized in other areas.	Reduce_costs		
reduce spending.	Reduce_costs		
save money in the school budget	Reduce_costs		
that funds could be saved.	Reduce_costs		
that it can address its financial shortfall	Reduce_costs		
that it could balance it's budget.	Reduce_costs		
that it could cut costs no matter what other people wanted.	Reduce_costs		
that it could save money due to a budget shortfall.	Reduce_costs		
that it could save money in the coming year	Reduce_costs		
that it could survive it’s budgetary problems.	Reduce_costs		
that it would not have to get money elsewhere to fund them.	Reduce_costs		
that money could be saved.	Reduce_costs		
that the school could make up a budget shortfall.	Reduce_costs		
that the school could reduce spending since it was expected to spend at least $4.5 million more than the budget allowed.	Reduce_costs		
that the school could save money and keep the university going.	Reduce_costs		
that the school could save more money.	Reduce_costs		
that the school could try to save some money.	Reduce_costs		
that the school would be able to meet it's budge.	Reduce_costs		
that the school would not be over-budget for the school year.	Reduce_costs		
that the school's budget could be balanced.	Reduce_costs		
that the university could reduce its financial troubles.	Reduce_costs		
that the university could save money.	Reduce_costs		
that the University would be within the spending budget.	Reduce_costs		
that their financial issues could be better addressed.	Reduce_costs		
that their school expected budget to be spent would at least be 4.5 million dollars	Reduce_costs		
that they can decrease the amount they have gone over for the budget.	Reduce_costs		
that they can reduce there financial problems.	Reduce_costs		
that they can save money.	Reduce_costs		
that they could contribute more money to men's sports.	Reduce_costs		
that they could cut back on financial troubles.	Reduce_costs		
that they could cut down on expenditure on sports teams within the school.	Reduce_costs		
that they could cut spending.	Reduce_costs		
that they could effectively reduced spend that was already over budget.	Reduce_costs		
that they could lessen the budget deficit.	Reduce_costs		
that they could meet their budget restrictions.	Reduce_costs		
that they could meet their budgetary goals.	Reduce_costs		
that they could reduce spending and fit the budget.	Reduce_costs		
that they could reduce spending.	Reduce_costs		
that they could reduce their sports spending budget	Reduce_costs		
that they could save enough money to balance their budget.	Reduce_costs		
that they could save money	Reduce_costs		
that they could save money and avert a financial crisis.	Reduce_costs		
that they could save money and spend what their budget could allow.	Reduce_costs		
that they could save money and stay within a reasonable budget to accommodate student and faculty needs.	Reduce_costs	Miscellaneous	
that they could save money because they were already so far over budget.	Reduce_costs		
that they could save money by reducing their sports programs.	Reduce_costs		
that they could save money due to the schools poor financial situation in 2018.	Reduce_costs		
that they could save money in a budget that was already experiencing a deficit.	Reduce_costs		
that they could save money in the long run.	Reduce_costs		
that they could save money on sports.	Reduce_costs		
that they could save money to be in closer alignment to their assigned budget.	Reduce_costs		
that they could save the school money.	Reduce_costs		
that they could save themselves from being over budget.	Reduce_costs		
that they could stay within their budget	Reduce_costs		
that they have money.	Reduce_costs		
that they would not go over their budget.	Reduce_costs		
the could balance the budget	Reduce_costs		
the institute could ease its financial trouble.	Reduce_costs		
the school could be saved finacially	Reduce_costs		
the school could cut spending to fall within its available budget.	Reduce_costs		
the school could meet their budget.	Reduce_costs		
the school could save money.	Reduce_costs		
the school would be able to save money and meet the budget allowed	Reduce_costs		
the university could save money.	Reduce_costs		
the university saved financially by eliminating to women's sports and three men's sports.	Reduce_costs		
their budget could be reduced since they were way over budget.	Reduce_costs		
they alleviate their financial problems.	Reduce_costs		
they can reduce expenditures.	Reduce_costs		
they can reduce spending.	Reduce_costs		
they can reduce the expected budge deficit.	Reduce_costs		
they can save money	Reduce_costs		
they can save money .	Reduce_costs		
they can save money and not spend it on those sports.	Reduce_costs		
they can save money to accomodate the budget	Reduce_costs		
they can save money.	Reduce_costs		
they can save more money	Reduce_costs		
they can save on money.	Reduce_costs		
they can save some money	Reduce_costs		
they can save some money.	Reduce_costs		
they can stay under budget for the next school year.	Reduce_costs		
they cold save money	Reduce_costs		
they could attempt to alleviate a $4.5 million budget shortfall.	Reduce_costs		
they could attempt to reduce expenses in their sports programs.	Reduce_costs		
they could attempt to stay under their spending budget.	Reduce_costs		
they could balance their budget	Reduce_costs		
they could be on budget.	Reduce_costs		
they could bring their financial obligations more in line with their budget.	Reduce_costs		
they could come up with their deficit.	Reduce_costs		
they could cut costs.	Reduce_costs		
they could cut down their budget.	Reduce_costs		
they could cut expenses for their budget that was already over by $4.5 million.	Reduce_costs	Miscellaneous	
they could cut expenses, but I think it was unfair, men were cut too.	Reduce_costs	Miscellaneous	
they could cut their deficit.	Reduce_costs		
they could cut their overspending.	Reduce_costs		
they could decrease their budget and not operate at a loss.	Reduce_costs		
they could free up money for other programs.	Reduce_costs		
they could have a better budget to be able to do other programs without having to spend so much on the ones they cut.	Reduce_costs	Miscellaneous	
they could have extra money to support the academic portion of the University.	Reduce_costs	Miscellaneous	
they could have more money	Reduce_costs		
they could help their financial situation.	Reduce_costs		
they could help themselves financially by saving money.	Reduce_costs		
they could improve their financial situation	Reduce_costs		
they could lessen the deficit the university had created.	Reduce_costs		
they could lower their expenses.	Reduce_costs		
they could maintain the budget they set.	Reduce_costs		
they could make an attempt to become financially more stable.	Reduce_costs		
they could meet their annual budget.	Reduce_costs		
they could meet their budget and not go over by $4.5 million.	Reduce_costs		
they could meet their budget demands.	Reduce_costs		
they could meet their budget the following year.	Reduce_costs		
they could meet their budget.	Reduce_costs		
they could offset a $4.5 million dollar shortfall expected by the university.	Reduce_costs		
they could operate on budget for the calendar year.	Reduce_costs		
they could reduce cost to the University.	Reduce_costs		
they could reduce costs.	Reduce_costs		
they could reduce debt.	Reduce_costs		
they could reduce spending.	Reduce_costs		
they could reduce the amount of money spent on sports programs.	Reduce_costs		
they could reduce the spending.	Reduce_costs		
they could save money	Reduce_costs		
they could save money .	Reduce_costs		
they could save money after going over their budget.	Reduce_costs		
they could save money and balance the budget.	Reduce_costs		
they could save money and help their budget shortfall of 4.5 million dollars.	Reduce_costs		
they could save money and keep the core academics of the school active.	Reduce_costs	Miscellaneous	
they could save money and reduce the budget.	Reduce_costs		
they could save money as the budget was over what they had.	Reduce_costs		
they could save money due to their financial troubles.	Reduce_costs		
they could save money for the university.	Reduce_costs		
they could save money from going over budget.	Reduce_costs		
they could save money in order to meet their budget.	Reduce_costs		
they could save money on the athletic budget.	Reduce_costs		
they could save money overall.	Reduce_costs		
they could save money to support their overall budget.	Reduce_costs		
they could save money.	Reduce_costs		
they could save more money.	Reduce_costs		
they could save more on the budget.	Reduce_costs		
they could save some money without interfering with academic expenses.	Reduce_costs	Miscellaneous	
they could save some money!	Reduce_costs		
they could save some money.	Reduce_costs		
they could save themselves money.	Reduce_costs		
they could stay solvent.	Reduce_costs		
they could stay within their budget.	Reduce_costs		
they could try and not go over their budget.	Reduce_costs		
they cut back on losing money.	Reduce_costs		
they saved money	Reduce_costs		
they saved more money	Reduce_costs		
they will not be over budget.	Reduce_costs		
they would be able to put the money spent on the teams back into the school's budget.	Reduce_costs		
they would be able to save money on their budget.	Reduce_costs		
they would be able to stay within their annual budget.	Reduce_costs		
they would hopefully be at or under budget in the upcoming year.	Reduce_costs		
they would not go over budget.	Reduce_costs		
they would not go over there budget.	Reduce_costs		
they would save money.	Reduce_costs		
they wouldn't be over budget	Reduce_costs		
they're saving money.	Reduce_costs		
to save money	Reduce_costs		
to save money foe future projected spending.	Reduce_costs		
to save money, the school reduced its sports programs including the men's wrestling, men's swimming and diving, women's tennis, and women's softball teams would not continue in the fall.	Reduce_costs	Would_not_continue	
a lawsuit ruling forced them to reinstate the sports.	Teams_got_reinstated		
now the have to reinstate programs per the Title IX.	Teams_got_reinstated		
they explain to the reason why and still sued and correccted it afterwards.	Teams_got_reinstated	Miscellaneous	
They school had to reinstate both programs.	Teams_got_reinstated		
when the population of women at the University lowered to a very unequal ratio, they reinstated them.	Teams_got_reinstated	Miscellaneous	
it would not continue in the fall.	Would_not_continue		
the teams would not continue in the fall.	Would_not_continue		
these sports would not be available to students in the fall.	Would_not_continue		
softball players could no longer play in the fall.	Would_not_continue		
the school reduced its sports programs.	Would_not_continue		
the women's softball team would not continue in the fall.	Would_not_continue		
these two sports were no longer offered at the school.	Would_not_continue		
they would not continue in the fall.	Would_not_continue		
women could not play tennis and softball at the university.	Would_not_continue		
women were not able to play tennis or softball at Eastern Michigan University.	Would_not_continue		
women's softball teams would not continue in the fall.	Would_not_continue		
