Governments should make voting compulsory so everyone is represented in the government.	Rep_
Governments should make voting compulsory so a civic right and not a civic duty.	Other
Governments should make voting compulsory so a country can determine percentage of the majority.	Other
Governments should make voting compulsory so a high voter turn out takes part in their democracy.	Vote_
Governments should make voting compulsory so a more accurate representation of the nation's views are captured by the polls.	Rep_
Governments should make voting compulsory so a representative is elected by the community as a whole.	Leaders_Rep_
Governments should make voting compulsory so a true majority of the population is represented by the winner.	Rep_
Governments should make voting compulsory so all adults feel involved in the electoral process and have an impact on who is elected.	Feel_Rep_
Governments should make voting compulsory so all citizen compulsory to vote.	Other
Governments should make voting compulsory so all citizen should be vote compulsory.	Other
Governments should make voting compulsory so all citizen to vote any candidates	Other
Governments should make voting compulsory so all citizens are given a voice.	Rep_
Governments should make voting compulsory so all citizens are involved in electing their leaders.	Leaders_Vote_
Governments should make voting compulsory so all citizens are involved, educated, and the nation as a whole elects suitable president.	Leaders_Vote_
Governments should make voting compulsory so all citizens can have their choices heard, and maybe change the system to their liking.	Rep_
Governments should make voting compulsory so all citizens can vote equally.	Other
Governments should make voting compulsory so all citizens have a chance to cast a vote.	Other
Governments should make voting compulsory so all citizens have their voice heard.	Rep_
Governments should make voting compulsory so all citizens participate	Vote_
Governments should make voting compulsory so all citizens participate in choosing their government.	Vote_
Governments should make voting compulsory so all citizens voice their choice of representation.	Rep_
Governments should make voting compulsory so all citizens will vote to ensure the majority of the population is represented.	Vote_Rep_
Governments should make voting compulsory so all democracies can have their representative governments.	Rep_
Governments should make voting compulsory so all may be accounted for.	Rep_
Governments should make voting compulsory so all of our need will be fulfilled by the candidate whom we think he is the right indeed.	Other
Governments should make voting compulsory so all of their citizens vote.	Vote_
Governments should make voting compulsory so all people are represented in the country.	Rep_
Governments should make voting compulsory so all registered voters will vote on any election or will be punished by government.	Vote_
Governments should make voting compulsory so all the people should be involved in the election.	Other
Governments should make voting compulsory so all the registered voters---the great majority of adult citizens---participate in making a choice that effects them all.	Vote_
Governments should make voting compulsory so all voices can be heard.	Rep_
Governments should make voting compulsory so all voices have an equal say in the government	Rep_
Governments should make voting compulsory so an active minority cannot disproportionately control power.	Other
Governments should make voting compulsory so as to ensure good leadership	Leaders_
Governments should make voting compulsory so as to ensure that elected officials represent the majority.	Leaders_Rep_
Governments should make voting compulsory so as to ensures that the elected government represents the majority of the population.	Rep_
Governments should make voting compulsory so as to increase voter participation.	Vote_
Governments should make voting compulsory so as to raise low voter turnout.	Vote_
Governments should make voting compulsory so at least no one can make the joke, " You cant talk, you didn't vote!"	Other
Governments should make voting compulsory so beacause of majority of population	Other
Governments should make voting compulsory so But those against compulsory voting say that it is a violation of personal liberties and choices	Other
Governments should make voting compulsory so but those voting ensures that the elected government represents the majority of the population	Rep_
Governments should make voting compulsory so candidates will be elected according to the majority of all votes.	Rep_
Governments should make voting compulsory so citizen will go and vote.	Vote_
Governments should make voting compulsory so citizens are encouraged to participate in the voting process.	Vote_
Governments should make voting compulsory so citizens are more encouraged to participate.	Vote_
Governments should make voting compulsory so citizens can decide who they want to be their leaders.	Leaders_Rep_
Governments should make voting compulsory so citizens can directly engage in elections and help make the important decision that will directly affect them.	Vote_Rep_
Governments should make voting compulsory so citizens can participate in deciding the direction of their country.	Vote_
Governments should make voting compulsory so citizens can perform their civic duty.	Duty_
Governments should make voting compulsory so citizens can see the importance in their stance regardless of how they may feel about past election policies or outcomes.	Other
Governments should make voting compulsory so citizens feel they have a voice and that the results represent the majority vote.	Feel_Rep_
Governments should make voting compulsory so citizens get in involved in politics and know the issues and the candidates and can make informed choices when they vote.	Vote_
Governments should make voting compulsory so citizens have more say in politics.	Rep_
Governments should make voting compulsory so citizens realize their voice is critical in their country's decisions.	Other
Governments should make voting compulsory so citizens take a more active part in government.	Vote_
Governments should make voting compulsory so citizens to not feel like their civil liberties are violated.	Other
Governments should make voting compulsory so citizens utilize their civil duty.	Duty_
Governments should make voting compulsory so citizens will become involved with participating in government and be more knowledgeable about their civic duty.	Rep_Duty_
Governments should make voting compulsory so citizens will have to vote and will vote in high numbers/percentages.	Vote_
Governments should make voting compulsory so community groups and politically motivated action groups should work very hard to inform every otherwise uninformed voter.	Other
Governments should make voting compulsory so companies should give adequate time off to be able to do so.	Other
Governments should make voting compulsory so Compulsory vote for any one.	Other
Governments should make voting compulsory so corrupt leaders do not assume power.	Other
Governments should make voting compulsory so countries that don't have compulsory voting should change their laws.	Other
Governments should make voting compulsory so democracies have representative governments	Rep_
Governments should make voting compulsory so democracies have representative governments.	Rep_
Governments should make voting compulsory so democracies will have representative governments.	Rep_
Governments should make voting compulsory so democracy can be in full effect.	Other
Governments should make voting compulsory so democracy can thrive by properly representing all the people.	Rep_
Governments should make voting compulsory so develop awareness	Other
Governments should make voting compulsory so each citizen gets a fair say in electing government officials.	Rep_
Governments should make voting compulsory so each person will keep up on the politics as they do American Idol.	Other
Governments should make voting compulsory so elected government represents the majority.	Rep_
Governments should make voting compulsory so elected governments are representative of the majority of the population.	Rep_
Governments should make voting compulsory so elected officials more accurately represent the views of the nation as a whole.	Leaders_Rep_
Governments should make voting compulsory so elected officials represent the majority of the popuultation.	Leaders_Rep_
Governments should make voting compulsory so elected representatives represent the majority of the population	Leaders_Rep_
Governments should make voting compulsory so Election Day should be made a national holiday allowing citizens the opportunity to exercise their right to vote.	Other
Governments should make voting compulsory so election results represent the full will of the prople.	Rep_
Governments should make voting compulsory so elections are a more accurate representation of the electorate.	Rep_
Governments should make voting compulsory so elections are as fair as possible.	Other
Governments should make voting compulsory so elections are representative of all the people.	Rep_
Governments should make voting compulsory so elections have better turnouts and can more accurately reflect the public's opinions.	Vote_Rep_
Governments should make voting compulsory so elections have good turnout.	Vote_
Governments should make voting compulsory so elections will be more legitimate by encouraging high voter turnout.	Vote_
Governments should make voting compulsory so ensures that the elected government represents the majority of the population	Rep_
Governments should make voting compulsory so ensures that the elected government represents the majority of the population.	Rep_
Governments should make voting compulsory so even uninformed voters could vote based on what mainstream media says.	Other
Governments should make voting compulsory so every American is insured their individual right.	Other
Governments should make voting compulsory so every citizen can be heard.	Rep_
Governments should make voting compulsory so every citizen exercises its responsibility and duty.	Vote_Duty_
Governments should make voting compulsory so every citizen has a civic right and duty to vote.	Duty_
Governments should make voting compulsory so every citizen plays an active part in politics.	Vote_
Governments should make voting compulsory so every citizen will actually vote	Vote_
Governments should make voting compulsory so every citizen will have the democratic right to express their own political choices.	Rep_
Governments should make voting compulsory so every citizen will understand their responsibility and the value of democracy	Duty_
Governments should make voting compulsory so every has to cast their vote.	Vote_
Governments should make voting compulsory so every one of its citizens voices and opinions can be heard.	Rep_
Governments should make voting compulsory so every one votes	Vote_
Governments should make voting compulsory so every person has an active role in choosing leaders.	Leaders_
Governments should make voting compulsory so every single citizen has their voice heard.	Rep_
Governments should make voting compulsory so every voice and interest is heard and represented.	Rep_
Governments should make voting compulsory so every voice is heard.	Rep_
Governments should make voting compulsory so every vote is counted	Rep_
Governments should make voting compulsory so every voter truly has a voice instead of relying on the few who do vote.	Rep_
Governments should make voting compulsory so everybody is forced to make a choice between the candidates.	Other
Governments should make voting compulsory so everyone can have a say in how their government is run.	Rep_
Governments should make voting compulsory so everyone can make their vote count.	Other
Governments should make voting compulsory so everyone can take part in the electoral process.	Vote_
Governments should make voting compulsory so everyone feels like they are involved in their country.	Other
Governments should make voting compulsory so everyone gets a vote.	Other
Governments should make voting compulsory so everyone gets an equal say in who is elected.	Rep_
Governments should make voting compulsory so everyone gets out and votes.	Vote_
Governments should make voting compulsory so everyone gets to voice their opinion.	Rep_
Governments should make voting compulsory so everyone has a chance to voice their opinion and make the elections fair.	Rep_
Governments should make voting compulsory so everyone has a say in the country's future.	Vote_
Governments should make voting compulsory so everyone has a say in their government.	Rep_
Governments should make voting compulsory so everyone has a say in what happens in their country.	Rep_
Governments should make voting compulsory so everyone has a say in who is elected.	Leaders_Rep_
Governments should make voting compulsory so everyone has a say so in who they want in office and etc	Leaders_Rep_
Governments should make voting compulsory so everyone has a say.	Rep_
Governments should make voting compulsory so everyone has a stake in the process	Rep_
Governments should make voting compulsory so everyone has a voice or choice in their election candidates and their governments.	Leaders_Rep_
Governments should make voting compulsory so everyone has an opportunity to express their views about their country.	Rep_
Governments should make voting compulsory so everyone has their voice heard.	Rep_
Governments should make voting compulsory so everyone in the country has a voice.	Rep_
Governments should make voting compulsory so everyone is forced to cast a ballot and the candidate who has the most votes wins.	Vote_
Governments should make voting compulsory so everyone is represented.	Rep_
Governments should make voting compulsory so everyone is sure to have a say in the way things turn out and have a chance to change things for the better.	Vote_
Governments should make voting compulsory so everyone participates in the political system.	Vote_
Governments should make voting compulsory so everyone participates.	Vote_
Governments should make voting compulsory so everyone should have to vote unless he or she has a legitimate excuse.	Other
Governments should make voting compulsory so everyone takes an active role in politics.	Vote_
Governments should make voting compulsory so everyone votes and everyone has a say in their government.	Vote_Rep_
Governments should make voting compulsory so everyone who can vote has a say in what's happening in government.	Rep_
Governments should make voting compulsory so everyone who is able to vote can.	Vote_
Governments should make voting compulsory so everyone will be represented at the polls.	Rep_
Governments should make voting compulsory so everyone will vote.	Vote_
Governments should make voting compulsory so everyone would feel their opinion on leadership is felt.	Feel_
Governments should make voting compulsory so everyone would vote, not just a few.	Vote_
Governments should make voting compulsory so everyone's opinion is tallied.	Other
Governments should make voting compulsory so everyone's voice and opinion can be represented in our government.	Rep_
Governments should make voting compulsory so everyone's voice can be heard.	Rep_
Governments should make voting compulsory so everyone's voice has the fair and equal chance to be heard.	Rep_
Governments should make voting compulsory so everyone's voice is heard.	Rep_
Governments should make voting compulsory so everyone's voice is heard.	Rep_
Governments should make voting compulsory so everyone's voice matters.	Rep_
Governments should make voting compulsory so everyone’s opinion is counted.	Rep_
Governments should make voting compulsory so everyone’s voice is heard and counted.	Rep_
Governments should make voting compulsory so everyones voices can be heard.	Rep_
Governments should make voting compulsory so governments will be representative.	Rep_
Governments should make voting compulsory so hat a real and honest representation can be made, and candidates will not squeak in despite doing awful things.	Rep_
Governments should make voting compulsory so having clear requirements and exceptions are necessary.	Other
Governments should make voting compulsory so he elected government represents the majority of the population.	Rep_
Governments should make voting compulsory so he is an election	Other
Governments should make voting compulsory so he was like to him	Other
Governments should make voting compulsory so helping individuals vote is one approach to further engage the individuals we serve, Additionally, casting a ballot is related to a large group of positive advantages.	Other
Governments should make voting compulsory so higher voter turnout can increase confidence in the representation of the majority by our elected officials.	Leaders_Vote_Rep_
Governments should make voting compulsory so it becomes part of a culture.	Other
Governments should make voting compulsory so it can be seen as a civic right and not a civic duty.	Other
Governments should make voting compulsory so it can be seen as a civic right and not a civic duty.	Other
Governments should make voting compulsory so it can be the civic duty.	Duty_
Governments should make voting compulsory so it can encourages the high percentage of abstaining voters to participate in elections.	Vote_
Governments should make voting compulsory so it can ensure that the elected government represents the majority of the population.	Rep_
Governments should make voting compulsory so it can help us create a fair world and everyone has the right to vote for their future	Other
Governments should make voting compulsory so it can hopefully be a true democracy.	Other
Governments should make voting compulsory so it can require days off so that everyone has the chance to.	Other
Governments should make voting compulsory so it could be a more fair election	Other
Governments should make voting compulsory so it creates an atmosphere most similar to a true democracy - where the winning candidate is more likely to represent the majority of voters.	Leaders_Rep_
Governments should make voting compulsory so it encourages voter participation.	Vote_
Governments should make voting compulsory so it ensures that the elected government represents the majority of the population	Rep_
Governments should make voting compulsory so it ensures that the elected government represents the majority of the population.	Rep_
Governments should make voting compulsory so it ensures that the elected government represents the majority of the population.	Rep_
Governments should make voting compulsory so it ensures the elected government represents the majority of the population.	Rep_
Governments should make voting compulsory so it helps them	Other
Governments should make voting compulsory so it is a civic duty	Duty_
Governments should make voting compulsory so it is a civic right and not a civic duty	Other
Governments should make voting compulsory so it is a civic right not duty.	Other
Governments should make voting compulsory so it is difficult to view voting as a civic right instead of a civic duty.	Other
Governments should make voting compulsory so it is important that control mechanisms be created so that this favors democracy	Other
Governments should make voting compulsory so IT IS MOST IMPORTANT OF THE PEOPLE	Other
Governments should make voting compulsory so It is undemocratic to force people to vote	Other
Governments should make voting compulsory so it makes elections more representative of the public because more people will vote.	Vote_Rep_
Governments should make voting compulsory so it might make sense to reward those who are most consistent with their voting.	Other
Governments should make voting compulsory so it represents the majority of voters.	Rep_
Governments should make voting compulsory so it should be followed	Other
Governments should make voting compulsory so it should be seen as a civic duty rather than a civic right.	Duty_
Governments should make voting compulsory so it shows a majority vote for president.	Leaders_
Governments should make voting compulsory so it shows that the elected government represents the majority population .	Rep_
Governments should make voting compulsory so it was easily find the real citizen in the country.	Other
Governments should make voting compulsory so it will be considered a civic right, not a civic duty.	Other
Governments should make voting compulsory so it will be easier for dictators to take control.	Other
Governments should make voting compulsory so it will give the elections a broader answer and spectrum of what side the people are on.	Other
Governments should make voting compulsory so it will help our nation and make peace in our country.	Other
Governments should make voting compulsory so it would solve the low voter turnout issue.	Vote_
Governments should make voting compulsory so it's always best to give people options and the freedom to vote	Other
Governments should make voting compulsory so let's make sure they do not misuse their power.	Other
Governments should make voting compulsory so lets make election day a holiday.	Other
Governments should make voting compulsory so low voter turnout does not occur.	Vote_
Governments should make voting compulsory so Low voter turnout is a common problem in countries without compulsory voting	Other
Governments should make voting compulsory so low voter turnout is avoided.	Vote_
Governments should make voting compulsory so low voter turnout isn't a problem.	Vote_
Governments should make voting compulsory so mail in ballots will provide an easy way to enact that.	Other
Governments should make voting compulsory so majority of population votes, representation reflects the population.	Vote_Rep_
Governments should make voting compulsory so majority of the population is represented by the elected government.	Rep_
Governments should make voting compulsory so mandatory voting may seem like a great way to encourage voter participation.	Vote_
Governments should make voting compulsory so many more citizens will exercise their right to vote.	Vote_
Governments should make voting compulsory so many people are involved in the voting system because the citizen have a right to have his or her voice.	Other
Governments should make voting compulsory so many people who were not going to vote will cast their ballot	Vote_
Governments should make voting compulsory so more citizens are compelled to exercise their civil duties.	Duty_
Governments should make voting compulsory so more input from people can actually be accounted for.	Rep_
Governments should make voting compulsory so more of the citizens turn out to elections creating a more representative election and engagement in the political process.	Vote_Rep_
Governments should make voting compulsory so more of the citizens turn out to elections creating a more representative election and engagement in voting.	Vote_Rep_
Governments should make voting compulsory so more of the populace will become active in the political process.	Vote_
Governments should make voting compulsory so more of the population is represented in politics.	Rep_
Governments should make voting compulsory so more of the population will vote.	Vote_
Governments should make voting compulsory so more people are forced to be involved in voting.	Vote_
Governments should make voting compulsory so more people can exercise who they really want in office.	Other
Governments should make voting compulsory so more people can feel part of the process	Feel_
Governments should make voting compulsory so more people get involved in their own government.	Vote_
Governments should make voting compulsory so more people get to voice their opinions at the polls.	Vote_
Governments should make voting compulsory so more people go to the polls to vote.	Vote_
Governments should make voting compulsory so more people pay attention to what's going on in the government, and can't play the 'poor me' helpless card.	Other
Governments should make voting compulsory so more people take part in the political process.	Vote_
Governments should make voting compulsory so more people vote and the population is better represented in the government officials who get elected.	Leaders_Vote_Rep_
Governments should make voting compulsory so more people vote but im against the punishment side of it.	Vote_
Governments should make voting compulsory so more people vote in office elections than for television contests.	Vote_
Governments should make voting compulsory so more people vote in the elections.	Vote_
Governments should make voting compulsory so more people vote so the true winner can win	Vote_
Governments should make voting compulsory so more people vote.	Vote_
Governments should make voting compulsory so more people will actually get out and vote during an election.	Vote_
Governments should make voting compulsory so more people will be concerned with politics.	Other
Governments should make voting compulsory so more people will be interested in politics.	Other
Governments should make voting compulsory so more people will be involved in the government.	Rep_
Governments should make voting compulsory so more people will vote.	Vote_
Governments should make voting compulsory so more people would vote and be engaged in the political process of their country.	Vote_
Governments should make voting compulsory so more people would vote.	Vote_
Governments should make voting compulsory so more people's voices are heard.	Rep_
Governments should make voting compulsory so more voices are heard and properly represented.	Rep_
Governments should make voting compulsory so most citizens will vote.	Vote_
Governments should make voting compulsory so Most democratic governments	Other
Governments should make voting compulsory so Most democratic governments consider participating in national elections a right.	Other
Governments should make voting compulsory so most of the country is able to participate in the democracy.	Other
Governments should make voting compulsory so need population is very important	Other
Governments should make voting compulsory so new voters such as young adults can see that their vote makes a difference in the world and that they matter in the elections.	Other
Governments should make voting compulsory so no one's views are left out of the political process.	Rep_
Governments should make voting compulsory so nobody can say they didn’t have a chance to influence the election.	Rep_
Governments should make voting compulsory so only our rules will become good	Other
Governments should make voting compulsory so others can have a voice or if they want to be incognito.	Rep_
Governments should make voting compulsory so participation in voting can increase and elections are more fair, honest, and representative for all people, not just those who happen to make their voices heard because they feel	Vote_Rep_
Governments should make voting compulsory so people actually feel as though their votes count and actually means something.	Feel_
Governments should make voting compulsory so people all have a voice, and our true feelings and thoughts are out there for all to see.	Rep_
Governments should make voting compulsory so people are required to make a choice.	Other
Governments should make voting compulsory so people become more aware of laws and how their government works and what their rights are as a citizen.	Other
Governments should make voting compulsory so people can attend and vote	Other
Governments should make voting compulsory so people can be a part of choosing the course of government	Other
Governments should make voting compulsory so people can be in charge of who is in charge.	Leaders_Rep_
Governments should make voting compulsory so people can contribute to politics and fulfill their civic duty.	Vote_Duty_
Governments should make voting compulsory so people can feel encouraged to have their voice heard.	Other
Governments should make voting compulsory so people can feel that they have control over their choices and lives without being penalized.	Other
Governments should make voting compulsory so people can not say that their voice isn't heard or they don't have a say in government.	Rep_
Governments should make voting compulsory so people can participate in the election.	Vote_
Governments should make voting compulsory so people can participate in the political process.	Vote_
Governments should make voting compulsory so people can pay more attention to the candidates and pick whose right for the job.	Other
Governments should make voting compulsory so people care about their decisions.	Other
Governments should make voting compulsory so people get an opportunity as it is a civil right.	Other
Governments should make voting compulsory so people have a say in how the goverment is run.	Rep_
Governments should make voting compulsory so people have the ability to think before they vote	Other
Governments should make voting compulsory so people have to at least vote the government does not manipulate so much	Other
Governments should make voting compulsory so people know that they have a voice and a choice, choosing to vote over being forced to is a completely different perspective.	Other
Governments should make voting compulsory so people make the effort to participate.	Vote_
Governments should make voting compulsory so people take more interest in political elections and elected officials truly represent what the people choose.	Leaders_Rep_
Governments should make voting compulsory so people will be forced to make a decision on who they want elected rather than taking a more passive approach and not vote at all.	Leaders_Vote_
Governments should make voting compulsory so people will be more involved in politics.	Vote_
Governments should make voting compulsory so people will exercise their civic responsibility.	Duty_
Governments should make voting compulsory so people will see voting as a civic duty and government leaders will become more representative of the people.	Rep_Duty_
Governments should make voting compulsory so people's liberties are respected.	Other
Governments should make voting compulsory so perhaps a more accurate public opinion could be gained.	Rep_
Governments should make voting compulsory so PLEASE PEOPLE VOTING COMPULSORY	Other
Governments should make voting compulsory so results are a better representation of the population as a whole.	Rep_
Governments should make voting compulsory so Some people find it discouraging that voting for American Idol seems to generate more enthusiasm than voting in national elections.	Other
Governments should make voting compulsory so some places, like Australia and Bolivia, already have.	Other
Governments should make voting compulsory so someone will get elected who represents the majority of the population.	Leaders_Rep_
Governments should make voting compulsory so t represents elections for the country	Other
Governments should make voting compulsory so that a bigger turnout would show proper numbers to represent our actual votes.	Vote_
Governments should make voting compulsory so that a decline in voter turnout, like the 30% drop in Venezuela, is avoided	Vote_
Governments should make voting compulsory so that a majority of the population actually elects the government.	Rep_
Governments should make voting compulsory so that a majority of the population will vote and have representation on Election Day.	Vote_Rep_
Governments should make voting compulsory so that a true majority of voters are represented by the winner of the election.	Rep_
Governments should make voting compulsory so that a true majority will be elected.	Other
Governments should make voting compulsory so that a true popular vote elects the candidate.	Other
Governments should make voting compulsory so that adults are proactive and take part in the decision-making that shapes their lives.	Vote_
Governments should make voting compulsory so that all citizens can have a say in political affairs.	Rep_
Governments should make voting compulsory so that all citizens get a voice in government, not just those who are able to make it to the polls.	Rep_
Governments should make voting compulsory so that all citizens have an opportunity to pick their elected leaders.	Leaders_Rep_
Governments should make voting compulsory so that all citizens of voting age will know their vote counted	Feel_
Governments should make voting compulsory so that all elections are representative of the people's will.	Rep_
Governments should make voting compulsory so that all eligible able-bodied voters will vote.	Vote_
Governments should make voting compulsory so that all eligible voters are required to vote.	Vote_
Governments should make voting compulsory so that all eligible voters will make the effort to vote.	Vote_
Governments should make voting compulsory so that all of American is voting and not just a few	Vote_
Governments should make voting compulsory so that all people are encouraged to participate in the election process.	Vote_
Governments should make voting compulsory so that all people as equal have equal input equally, the focus should be more on "get to " rather than "have"to.	Other
Governments should make voting compulsory so that all people contribute to the outcome.	Vote_
Governments should make voting compulsory so that all people participate in a fair election of the most favorable candidate.	Leaders_Vote_
Governments should make voting compulsory so that all people vote and are represented by their government.	Vote_Rep_
Governments should make voting compulsory so that all people will vote and have a voice in elections.	Vote_Rep_
Governments should make voting compulsory so that all qualified citizens know that they will have a voice in the government.	Feel_
Governments should make voting compulsory so that all the citizens have a say in who is elected.	Leaders_Rep_
Governments should make voting compulsory so that all the people of the country are held accountable for who is chosen.	Other
Governments should make voting compulsory so that all voices are heard and so elections are better represented by the people.	Rep_
Governments should make voting compulsory so that all voters are heard.	Rep_
Governments should make voting compulsory so that apathetic citizens start to care about elections	Apathy_
Governments should make voting compulsory so that apathetic people start to care about elections	Apathy_
Governments should make voting compulsory so that as many people as possible have a say in how their government is run and by whom.	Leaders_Rep_
Governments should make voting compulsory so that citizens get more involved in politics and have more enthusiasm	Vote_
Governments should make voting compulsory so that citizens have more incentive to educate themselves in the world of politics.	Other
Governments should make voting compulsory so that citizens perform their civic duty.	Duty_
Governments should make voting compulsory so that citizens perform their obligations	Duty_
Governments should make voting compulsory so that citizens will learn to be involved in American politics just as much as are with American Idol.	Other
Governments should make voting compulsory so that citizens will participate in electing their officials.	Leaders_Vote_
Governments should make voting compulsory so that compulsory voting ensures that the elected government represents the majority of the population	Rep_
Governments should make voting compulsory so that corrupt politicians can be eliminated from office.	Other
Governments should make voting compulsory so that democracies can have a more complete representative government.	Rep_
Governments should make voting compulsory so that dictatorships are everywhere & the government can direct people to conformity,	Other
Governments should make voting compulsory so that each and every citizen cn and will excercise their voting rights and teh democracy gets afair idea of who the people want to represent them.	Vote_Rep_
Governments should make voting compulsory so that each and every citizen will excercise their voting rights and the democracy gets an accurate idea of who the people want as a leader to represent them.	Leaders_Vote_Rep_
Governments should make voting compulsory so that each citizen has an equal voice.	Other
Governments should make voting compulsory so that each person feels like he has a say i n how his life is governed.	Feel_
Governments should make voting compulsory so that each person's vote can be heard.	Rep_
Governments should make voting compulsory so that each voice is heard in government and politics.	Rep_
Governments should make voting compulsory so that elected government represents the majority of constituents.	Rep_
Governments should make voting compulsory so that elected government represents the majority of the population	Rep_
Governments should make voting compulsory so that elected leaders are actually who the majority of the country wants in power.	Leaders_
Governments should make voting compulsory so that elected officials are given the support of the people they represent.	Leaders_Rep_
Governments should make voting compulsory so that elected officials are representative of the population's preference.	Leaders_Rep_
Governments should make voting compulsory so that elected officials represent a majority of the population.	Leaders_Rep_
Governments should make voting compulsory so that elected officials represent the majority of the population and what the citizens want.	Leaders_Rep_
Governments should make voting compulsory so that elected officials represent the will of all or most of the people.	Leaders_Rep_
Governments should make voting compulsory so that elected officials will more closely resemble representatives of the people that vote them in	Leaders_Rep_
Governments should make voting compulsory so that elected officials will truly represent the majority of the populace.	Leaders_Rep_
Governments should make voting compulsory so that election results represent the greatest number of people.	Rep_
Governments should make voting compulsory so that elections are fair because everyone voted.	Vote_
Governments should make voting compulsory so that elections receive as much attention as American Idol	Other
Governments should make voting compulsory so that elections reflect the feelings of the population.	Rep_
Governments should make voting compulsory so that eligible voters pay attention to politics and turn out to the polls.	Vote_
Governments should make voting compulsory so that employers are thus forced to give employees paid time to vote, thus ensuring employees are able to participate in democracy without being subject to employers' whims.	Other
Governments should make voting compulsory so that every citizen can be represented by the people they vote for	Other
Governments should make voting compulsory so that every citizen can have their will reflected in the laws that pass and the politicians who get elected.	Leaders_Rep_
Governments should make voting compulsory so that every citizen can help guide the politics in their country.	Rep_
Governments should make voting compulsory so that every citizen can make their vote count since its their civic duty.	Duty_
Governments should make voting compulsory so that every citizen can voice their opinion on who they want to govern them.	Leaders_Rep_
Governments should make voting compulsory so that every citizen cast their vote.	Vote_
Governments should make voting compulsory so that every citizen feels responsible to vote and would honestly make their decision in casting their votes.	Vote_
Governments should make voting compulsory so that every citizen has a chance to vote.	Other
Governments should make voting compulsory so that every citizen has a true say.	Rep_
Governments should make voting compulsory so that every citizen will feel like he/she matters.	Other
Governments should make voting compulsory so that every election is based on the popularity of the greatest amount of people	Other
Governments should make voting compulsory so that every eligible citizen will participate.	Vote_
Governments should make voting compulsory so that every person becomes more involved in voting and we have a more fair outcome to elections that TRULY represent the people.	Vote_Rep_
Governments should make voting compulsory so that every person can make their own decision as to whether they want to vote or not.	Other
Governments should make voting compulsory so that every person in the country has voted.	Vote_
Governments should make voting compulsory so that every person is represented.	Rep_
Governments should make voting compulsory so that every voice is heard.	Rep_
Governments should make voting compulsory so that every vote is counted and matters.	Rep_
Governments should make voting compulsory so that every voter goes to the polls.	Vote_
Governments should make voting compulsory so that every voter will have a say in who is elected or not.	Rep_
Governments should make voting compulsory so that everybody completes their civic duty.	Vote_Duty_
Governments should make voting compulsory so that everybody's voice is heard.	Rep_
Governments should make voting compulsory so that everyone becomes more involved with the affairs of the nation	Rep_
Governments should make voting compulsory so that everyone can express their opinion and the results of the election will be more accurate.	Rep_
Governments should make voting compulsory so that everyone can get out and vote and not have an excuse.	Vote_
Governments should make voting compulsory so that everyone can get their voices heard	Rep_
Governments should make voting compulsory so that everyone can get use to it and make it a habit.	Other
Governments should make voting compulsory so that everyone can have their voice heard without the need of riots and pickets or walkouts and without all the drama of such	Rep_
Governments should make voting compulsory so that everyone can have their vote count but allow those corrupting the system severe punishments.	Rep_
Governments should make voting compulsory so that everyone can participate in the government elections with high voter turnout.	Vote_
Governments should make voting compulsory so that everyone can perform their civic duty.	Duty_
Governments should make voting compulsory so that everyone could be heard	Rep_
Governments should make voting compulsory so that everyone does their duty by voting.	Vote_Duty_
Governments should make voting compulsory so that everyone exercises there right to vote for the person they find to be the best candidate.	Vote_
Governments should make voting compulsory so that everyone fully participates in our democracy.	Vote_
Governments should make voting compulsory so that everyone gets a fair chance to pick who they think would fit best to leader the country.	Leaders_Rep_
Governments should make voting compulsory so that everyone gets a fair election	Other
Governments should make voting compulsory so that everyone has a good reason to become more actively involved in the political process.	Vote_
Governments should make voting compulsory so that everyone has a say in how the country is run.	Rep_
Governments should make voting compulsory so that everyone has a say in our leadership.	Leaders_Rep_
Governments should make voting compulsory so that everyone has a voice in who gets elected.	Leaders_Rep_
Governments should make voting compulsory so that everyone has an equal chance to vote	Other
Governments should make voting compulsory so that everyone has an opportunity to make their voice heard.	Rep_
Governments should make voting compulsory so that everyone has their voice heard.	Rep_
Governments should make voting compulsory so that everyone in the country can have their voices be heard not just the few amounts of people that make the effort to go vote.	Rep_
Governments should make voting compulsory so that everyone is counted and the country has a deep understanding of its citizens.	Leaders_Rep_
Governments should make voting compulsory so that everyone is fairly represented.	Rep_
Governments should make voting compulsory so that everyone is performing their civic duty	Duty_
Governments should make voting compulsory so that everyone is represented.	Rep_
Governments should make voting compulsory so that everyone participates	Vote_
Governments should make voting compulsory so that everyone participates in the election and feels like their opinion was heard.	Vote_Feel_
Governments should make voting compulsory so that everyone participates on government.	Vote_
Governments should make voting compulsory so that everyone votes and has a say in their local politics.	Vote_
Governments should make voting compulsory so that everyone votes which makes the election fair.	Vote_
Governments should make voting compulsory so that everyone who qualifies to vote 8n an election are required to do so.	Other
Governments should make voting compulsory so that everyone who votes can have a say in the election choice.	Rep_
Governments should make voting compulsory so that everyone will have to vote but not be penalized.	Other
Governments should make voting compulsory so that everyone's opinion s counted, and no one is left out.	Rep_
Governments should make voting compulsory so that everyone's voice is heard during every election and to prevent voter intimidation and voter fraud.	Rep_
Governments should make voting compulsory so that everyone's voice is heard in a democracy, which is governed by the people.	Rep_
Governments should make voting compulsory so that everyone's voice is heard.	Rep_
Governments should make voting compulsory so that everyone's vote influences the election.	Rep_
Governments should make voting compulsory so that everyone’s vote and voice matters and is heard.	Rep_
Governments should make voting compulsory so that government by the people overrides government by whoever has the most power.	Other
Governments should make voting compulsory so that governments are more representative of the populations they serve.	Rep_
Governments should make voting compulsory so that governments are representative of its citizens.	Rep_
Governments should make voting compulsory so that governments do not misuse the power of mandatory voting.	Other
Governments should make voting compulsory so that he people understand that it is important for their contry.	Other
Governments should make voting compulsory so that higher voter turnout is assured and people do their civic duty.	Vote_Duty_
Governments should make voting compulsory so that it encourages citizens to vote for their desired candidate or help get the right person in office.	Leaders_Vote_
Governments should make voting compulsory so that it encourages people to vote and have a say in their government.	Vote_
Governments should make voting compulsory so that it ensures democracies have representative governments.	Rep_
Governments should make voting compulsory so that it ensures everyone vote and it encourages civic duty to the country.	Vote_Duty_
Governments should make voting compulsory so that it ensures that the elected government represents the majority of the population.	Rep_
Governments should make voting compulsory so that it ensures that the majority of the population is represented.	Rep_
Governments should make voting compulsory so that it ensures the population will vote for a candidate that is truly placed in office by the people and for the people.	Leaders_Rep_
Governments should make voting compulsory so that it has a larger vote count.	Vote_
Governments should make voting compulsory so that it is a fair election that represents all people of the land, which would discourage those political parties that use fear to dissuade dissenting voters.	Rep_
Governments should make voting compulsory so that it is certain that every citizen will cast a vote.	Vote_
Governments should make voting compulsory so that it is ensured that all citizens' wishes are represented.	Rep_
Governments should make voting compulsory so that it's easy for people to make up their minds.	Other
Governments should make voting compulsory so that its citizens will become better educated in politics and give an accurate representation of the interests of the people.	Rep_
Governments should make voting compulsory so that leaders of countries are represented by true feelings of the majority of people.	Rep_
Governments should make voting compulsory so that low voter turnout is avoided.	Vote_
Governments should make voting compulsory so that more citizens across the world become invested in their government's election process and try to find out more about potential candidates.	Other
Governments should make voting compulsory so that more citizens actually vote.	Vote_
Governments should make voting compulsory so that more of the country is required to vote instead of having options and values but not acting on them.	Vote_
Governments should make voting compulsory so that more of the population have their voices heard by voting.	Vote_Rep_
Governments should make voting compulsory so that more of the population will vote and their voices will be heard.	Vote_Rep_
Governments should make voting compulsory so that more people are involved in what happens in the world.	Other
Governments should make voting compulsory so that more people can be represented by the elected official.	Other
Governments should make voting compulsory so that more people can participate	Vote_
Governments should make voting compulsory so that more people participate in electing government officials.	Leaders_Vote_
Governments should make voting compulsory so that more people participate in this civic duty.	Vote_Duty_
Governments should make voting compulsory so that more people turn up to vote.	Vote_
Governments should make voting compulsory so that more people vote in 2020 than they did in the 2012 US Presidential election	Vote_
Governments should make voting compulsory so that more people will be able to be a voice in elections.	Rep_
Governments should make voting compulsory so that more people will cast their vote.	Vote_
Governments should make voting compulsory so that more people would vote.	Vote_
Governments should make voting compulsory so that more voices are represented in the political process.	Rep_
Governments should make voting compulsory so that nations do not suffer loss of voter participation such as that seen in Venezuela.	Vote_
Governments should make voting compulsory so that nearly all eligible voters actually vote.	Vote_
Governments should make voting compulsory so that no one can say they were not given the right to vote or that their vote was suppressed.	Other
Governments should make voting compulsory so that our elected officials are true representatives of the entire population not just special interest groups.	Leaders_Rep_
Governments should make voting compulsory so that participation and involvement are encouraged and increased.	Vote_
Governments should make voting compulsory so that participation in voting will be high.	Vote_
Governments should make voting compulsory so that people actually care who is elected.	Other
Governments should make voting compulsory so that people are more engaged with their government and actively create the society that they want to live in.	Vote_
Governments should make voting compulsory so that people are not forced to give inaccurate and misrepresented data.	Other
Governments should make voting compulsory so that people can have a chance at life.	Other
Governments should make voting compulsory so that people can put the candidate in office that they choose.	Rep_
Governments should make voting compulsory so that people cast a vote.	Vote_
Governments should make voting compulsory so that people elect the true choice in the election.	Other
Governments should make voting compulsory so that people get more involved with politics and help combat voter apathy.	Apathy_Vote_
Governments should make voting compulsory so that people understand the importance of voting and vote.	Vote_
Governments should make voting compulsory so that people understand their civic obligation and vote on election day	Vote_Duty_
Governments should make voting compulsory so that people will actually have a need to stay informed about what's going on in politics.	Other
Governments should make voting compulsory so that people will participate in elections and not grow apathetic towards politics.	Apathy_Vote_
Governments should make voting compulsory so that people will turn out to vote.	Vote_
Governments should make voting compulsory so that people won't blow off the countries future.	Other
Governments should make voting compulsory so that the best person gets the job.	Leaders_
Governments should make voting compulsory so that the bulk of the voting populace pays attention to politics.	Other
Governments should make voting compulsory so that the country can remain fair with its candidates	Other
Governments should make voting compulsory so that the country is accurately represented.	Rep_
Governments should make voting compulsory so that the elected government is a true representation of the people's vote.	Leaders_Rep_
Governments should make voting compulsory so that the elected government is representative of the majority of the population.	Rep_
Governments should make voting compulsory so that the elected government officials represent a majority of the population and not just the segment that choose to vote.	Rep_
Governments should make voting compulsory so that the elected government represent the majority of the population.	Rep_
Governments should make voting compulsory so that the elected government represents the majority of the population	Rep_
Governments should make voting compulsory so that the elected government represents the majority of the population,	Rep_
Governments should make voting compulsory so that the elected government represents the majority of the population.	Rep_
Governments should make voting compulsory so that the elected government represents the majority of the population.	Rep_
Governments should make voting compulsory so that the elected official is truly what the majority wanted.	Leaders_Rep_
Governments should make voting compulsory so that the elected official represents the majority.	Leaders_Rep_
Governments should make voting compulsory so that the elected officials are truly in office because the majority of the population wanted them there.	Leaders_Rep_
Governments should make voting compulsory so that the elected officials represent the majority of the population.	Leaders_Rep_
Governments should make voting compulsory so that the elected party and elected government can represent the majority of the population.	Rep_
Governments should make voting compulsory so that the election results show a truly democratic decision.	Rep_
Governments should make voting compulsory so that the entire population can participate in shaping the country they live in.	Vote_
Governments should make voting compulsory so that the entire population is properly represented.	Rep_
Governments should make voting compulsory so that the entire population may be heard, for good or for bad.	Rep_
Governments should make voting compulsory so that the governement is an actual representation of the people	Rep_
Governments should make voting compulsory so that the governing bodies reflect the will of the people and act as representatives of society's current needs and desires.	Rep_
Governments should make voting compulsory so that the government accurately represents its people.	Rep_
Governments should make voting compulsory so that the government could see who is qualified as a president	Leaders_
Governments should make voting compulsory so that the government is a more accurate reflection of the population's desires.	Rep_
Governments should make voting compulsory so that the government is representative of the people.	Rep_
Governments should make voting compulsory so that the government is truly reflective of the majority.	Rep_
Governments should make voting compulsory so that the government reflects the majority of the population.	Rep_
Governments should make voting compulsory so that the greatest number of voices are heard when deciding on our leaders.	Rep_
Governments should make voting compulsory so that the largest percentage of the public will vote and choose the officials they most want to be leading the country.	Leaders_Vote_
Governments should make voting compulsory so that the majority of people will vote, making sure the will of the people is heard.	Vote_Rep_
Governments should make voting compulsory so that the majority of the country is represented.	Rep_
Governments should make voting compulsory so that the majority of the people voice's will be heard.	Rep_
Governments should make voting compulsory so that the majority of the population have a say in their government representation.	Rep_
Governments should make voting compulsory so that the majority of the population is represented in the vote.	Rep_
Governments should make voting compulsory so that the majority of the population is represented.	Rep_
Governments should make voting compulsory so that the majority of the populous and their goals/beliefs/values are represented in our government.	Rep_
Governments should make voting compulsory so that the majority of voters get their voices heard.	Rep_
Governments should make voting compulsory so that the majority will vote the elected official in.	Vote_
Governments should make voting compulsory so that the number of people that vote on elections goes up.	Vote_
Governments should make voting compulsory so that the opinions of all citizens are heard.	Rep_
Governments should make voting compulsory so that the people can have more representative governments.	Rep_
Governments should make voting compulsory so that the people can voice their opinion.	Rep_
Governments should make voting compulsory so that the people have a better opportunity for choosing the right candidate for their country.	Leaders_Rep_
Governments should make voting compulsory so that the people know the chosen candidate is the voice of the major population	Leaders_Rep_
Governments should make voting compulsory so that the person elected accurately portrays the candidate that the country in whole wants in office.	Leaders_Rep_
Governments should make voting compulsory so that the person in office is who the people want there instead of just who ever feels like taking the seat.	Leaders_Rep_
Governments should make voting compulsory so that the person is elected was chosen by everyone.	Rep_
Governments should make voting compulsory so that the person voted in is the one that the majority of the population wants.	Leaders_Rep_
Governments should make voting compulsory so that the political representative with the best policies get into office.	Other
Governments should make voting compulsory so that the population has inventive to participate in the election process.	Vote_
Governments should make voting compulsory so That the population is better represented in the laws are more in line with what people want	Other
Governments should make voting compulsory so that the population is engaged in voting andthat these votes actually represent what they want	Vote_Rep_
Governments should make voting compulsory so that the problem of low voter turnout can be addressed.	Vote_
Governments should make voting compulsory so that the results of the election are a true reflection of the majority ofpeopl r not just a few	Rep_
Governments should make voting compulsory so that the results of the elections properly convey the will of all the people.	Rep_
Governments should make voting compulsory so that the running officials are selected by the majority.	Leaders_Rep_
Governments should make voting compulsory so that the same person gets elected every time.	Other
Governments should make voting compulsory so that the the odds of electing a government more representative of the majority of the citizens is hopefully improved.	Rep_
Governments should make voting compulsory so that the true majority vote winner will be chosen.	Rep_
Governments should make voting compulsory so that the true will of the people can be acted on.	Rep_
Governments should make voting compulsory so that the true winner of the vote has the majority of the country's support.	Other
Governments should make voting compulsory so that the use of the Electoral College is no longer necessary.	Other
Governments should make voting compulsory so that the vast majority can vote	Other
Governments should make voting compulsory so that the views of the entire population are more accurately depicted in the results.	Rep_
Governments should make voting compulsory so that the voter turnout in that country would increase.	Vote_
Governments should make voting compulsory so that the votes actually reflect and account for the entire community, not just a select few.	Rep_
Governments should make voting compulsory so that the votes are more representative of the country's populace.	Rep_
Governments should make voting compulsory so that the voting polls are more in line with everyone's views not jut a select few.	Rep_
Governments should make voting compulsory so that the will of the people can more accurately be represented.	Rep_
Governments should make voting compulsory so that the will of the people is genuinely represented.	Rep_
Governments should make voting compulsory so that the will of the people is reflected in elections.	Rep_
Governments should make voting compulsory so that the will of the People, not just of some people, can be carried out.	Rep_
Governments should make voting compulsory so that the wrong people do not vote and make the voting unfair	Other
Governments should make voting compulsory so that their democratic government can truly be representative of the people.	Rep_
Governments should make voting compulsory so that their people are represented fairly by the people they want to lead the country.	Leaders_Rep_
Governments should make voting compulsory so that there can be nobody saying that a leader would’ve been elected instead if everyone had voted.	Other
Governments should make voting compulsory so that there is a correlation between the population and the government in terms of representation.	Rep_
Governments should make voting compulsory so that there is a high voter turnout.	Vote_
Governments should make voting compulsory so that there is a higher voter turnout and the elected government is represented my a larger number of the population.	Vote_Rep_
Governments should make voting compulsory so that there is a higher voter turnout.	Vote_
Governments should make voting compulsory so that there is a large turnout.	Vote_
Governments should make voting compulsory so that there is a more representative government.	Rep_
Governments should make voting compulsory so that there is a much higher turnout at polls.	Vote_
Governments should make voting compulsory so that there is a reason for people to get involved in politics but there should be no punishment fir those who do not vote	Other
Governments should make voting compulsory so that there is a renewed political interest in our world that favors "American Idol" over choosing a worthy political candidate to run our governments.	Other
Governments should make voting compulsory so that there is greater participation by the citizens in electing their representatives.	Vote_
Governments should make voting compulsory so that there is larger voter turnout and a more accurate representation of what the population wants.	Vote_Rep_
Governments should make voting compulsory so that there is not a low voter turn out.	Vote_
Governments should make voting compulsory so that there will be a higher voter turnout and the entire populations voice is heard.	Vote_Rep_
Governments should make voting compulsory so that they are actually representing the majority of the population.	Rep_
Governments should make voting compulsory so that they are more representative of the full population.	Rep_
Governments should make voting compulsory so that they can get a good idea of the opinions of their people	Rep_
Governments should make voting compulsory so that they can get a more accurate representation of the nation's opinion on their policies and leaders.	Leaders_Rep_
Governments should make voting compulsory so that they can interfere with the civil liberties of their citizens.	Other
Governments should make voting compulsory so that they can learn the needs of the majority and truly support their country.	Leaders_Rep_
Governments should make voting compulsory so that they generate more interest in elections from the public.	Other
Governments should make voting compulsory so that they get the opinion of every citizen, not just a few.	Rep_
Governments should make voting compulsory so that they have good representation of what their citizens want for the laws.	Other
Governments should make voting compulsory so that they have majority of the population represented in the process.	Rep_
Governments should make voting compulsory so that they know what all eligible votes think.	Rep_
Governments should make voting compulsory so that they may stop falsifying votes, hopefully.	Other
Governments should make voting compulsory so that those elected are representing the will of the people.	Leaders_Rep_
Governments should make voting compulsory so that those elected better represent a majority of the population.	Leaders_Rep_
Governments should make voting compulsory so that true democracy exists in countries where voters are allowed to vote; if citizens don't vote their political desires can't be represented.	Rep_
Governments should make voting compulsory so that voter apathy does not allow people to complain after the election that the winner was not chosen by the majority.	Other
Governments should make voting compulsory so that voter participation is encouraged.	Vote_
Governments should make voting compulsory so that voter participation is encouraged.	Vote_
Governments should make voting compulsory so that voter participation is more encouraged.	Vote_
Governments should make voting compulsory so that voter participation is up.	Vote_
Governments should make voting compulsory so that voter participation will be encouraged.	Vote_
Governments should make voting compulsory so that voter turn out increases, ensuring that their government is a representative democracy.	Vote_Rep_
Governments should make voting compulsory so that voter turnout increases.	Vote_
Governments should make voting compulsory so that voter turnout is higher and people are more engaged in politics.	Vote_
Governments should make voting compulsory so that voter turnout is higher and that the government represents a true majority of the population.	Vote_Rep_
Governments should make voting compulsory so that voter turnout is higher and the true majority of the locality chooses who gets elected.	Vote_
Governments should make voting compulsory so that voter turnout is higher and we have a true representative democracy.	Vote_Rep_
Governments should make voting compulsory so that voter turnout is increased.	Vote_
Governments should make voting compulsory so that voter turnout is much higher.	Vote_
Governments should make voting compulsory so that voting can be seen as a civic right and not a civic duty.	Other
Governments should make voting compulsory so that voting should be seen as a civic right and not a civic duty.	Other
Governments should make voting compulsory so that way you get a 100% turn out by the voters.	Vote_
Governments should make voting compulsory so that we all actually have a real vote or not no vote	Other
Governments should make voting compulsory so that we all have to make sure that our government is taking care of us and not htat we are just letting then run rampant	Other
Governments should make voting compulsory so that we become more like Bolivia.	Other
Governments should make voting compulsory so that we can get areal feel for how the country as a whole feels.	Rep_
Governments should make voting compulsory so that we can have a fair election.	Other
Governments should make voting compulsory so that we can have greater voter participation and elect the best president/leaders.	Leaders_Vote_
Governments should make voting compulsory so that we can make sure that every citizen has a say in it's representation.	Duty_
Governments should make voting compulsory so that we can see more people take an interest in who is going to be our new president.	Leaders_
Governments should make voting compulsory so that we can select the right leader for betterment	Leaders_
Governments should make voting compulsory so that we get a true idea of what the people of the country want with how their votes fall.	Rep_
Governments should make voting compulsory so that we get the best person for our goverments	Leaders_
Governments should make voting compulsory so that we have representative democracies.	Rep_
Governments should make voting compulsory so that whoever is elected is the representation of the true majority of the population.	Rep_
Governments should make voting compulsory so that whoever is voted in is really the person that the people wanted not just the person that was voted in because most people did give their vote.	Rep_
Governments should make voting compulsory so that whomever is elected is a true representative of a majority of the people.	Rep_
Governments should make voting compulsory so that young people, as well as older, actually vote.	Vote_
Governments should make voting compulsory so that, if used responsibly, the results of elections would more accurately match how the voters in the country actually feel.	Rep_
Governments should make voting compulsory so the candidate elected is a good representation of the people.	Leaders_Rep_
Governments should make voting compulsory so the candidates will not just focus on one group of people but the country as a whole.	Other
Governments should make voting compulsory so the citizens have a true voice in their leadership.	Leaders_Rep_
Governments should make voting compulsory so the citizens will participate in the forming the good government and good leaders to run the country in good and growing path	Leaders_Vote_
Governments should make voting compulsory so the country can have true representation of the people.	Rep_
Governments should make voting compulsory so the country has a president whom all the citizens want.	Leaders_Rep_
Governments should make voting compulsory so the elected candidate is more representative of the population they will be governing.	Leaders_Rep_
Governments should make voting compulsory so the elected government accurately represents the people.	Rep_
Governments should make voting compulsory so the elected government is really representative of what the majority of citizens want.	Rep_
Governments should make voting compulsory so the elected government officials represent the population better.	Rep_
Governments should make voting compulsory so the elected government really is representing the true majority of the population, and not just those interested enough in politics to go vote.	Rep_
Governments should make voting compulsory so the elected government represents a majority of the people.	Rep_
Governments should make voting compulsory so the elected government represents a majority of the population.	Rep_
Governments should make voting compulsory so the elected government represents the majority of the population	Rep_
Governments should make voting compulsory so the elected government represents the majority of the population.	Rep_
Governments should make voting compulsory so the elected government represents the majority of the population.	Rep_
Governments should make voting compulsory so the elected government represents the majority.	Rep_
Governments should make voting compulsory so the elected official more accurately reflects the choice of the entire populace.	Leaders_Rep_
Governments should make voting compulsory so the elected official represents the majority of the population.	Leaders_Rep_
Governments should make voting compulsory so the elected official represents the masses.	Leaders_Rep_
Governments should make voting compulsory so the elected officials are accurately representing the voice of the populace.	Leaders_Rep_
Governments should make voting compulsory so the elected officials are more representative of the population as a whole.	Leaders_Rep_
Governments should make voting compulsory so the elected president/parliament/congress, etc. reflects more accurately the will of the people.	Leaders_Rep_
Governments should make voting compulsory so the elected representative is truly representing the population.	Leaders_Rep_
Governments should make voting compulsory so the elected represents the majority of the people	Leaders_Rep_
Governments should make voting compulsory so the election has more of the peoples input.	Rep_
Governments should make voting compulsory so the election is decided by all of the people, not just the ones who show up to vote.	Rep_
Governments should make voting compulsory so the election is representative of the whole nation.	Rep_
Governments should make voting compulsory so the election process can ultimately be as fair and comprehensive as possible.	Other
Governments should make voting compulsory so the election will be a true democracy.	Other
Governments should make voting compulsory so the elections reflect that the elected government represents all or most of their citizens.	Rep_
Governments should make voting compulsory so the electoral voters would have more insight of the people wishes.	Other
Governments should make voting compulsory so the federal government can finally make a voting holiday.	Other
Governments should make voting compulsory so the government can represent majority of the population	Rep_
Governments should make voting compulsory so the government is a true reflection of the will of the people.	Rep_
Governments should make voting compulsory so the government is accurately represented by the population.	Rep_
Governments should make voting compulsory so the government is representative of all citizens.	Rep_
Governments should make voting compulsory so the government represents the majority of the population	Rep_
Governments should make voting compulsory so the government represents the majority of the population.	Rep_
Governments should make voting compulsory so the governments can feel better about voter numbers.	Other
Governments should make voting compulsory so the governments' elected leaders are true representatives of their constituencies.	Leaders_Rep_
Governments should make voting compulsory so the job gets done.	Other
Governments should make voting compulsory so the majority gets what they want.	Rep_
Governments should make voting compulsory so the majority of citizens have a say in who runs their governments.	Leaders_Rep_
Governments should make voting compulsory so the majority of people vote, which makes democracy really representative	Vote_Rep_
Governments should make voting compulsory so the majority of people will actually vote for who they want to represent them.	Vote_Rep_
Governments should make voting compulsory so the majority of the population gets the candidate they want.	Leaders_Rep_
Governments should make voting compulsory so the majority of the population is represented.	Rep_
Governments should make voting compulsory so the majority of the population selects the favored candidate.	Leaders_Rep_
Governments should make voting compulsory so the majority of the r population is represented.	Rep_
Governments should make voting compulsory so the majority of the voting public is represented.	Rep_
Governments should make voting compulsory so the majority of voices are heard in the election results.	Rep_
Governments should make voting compulsory so the majority rule is reflected with regards to all citizens.	Rep_
Governments should make voting compulsory so the masses can elect their choice	Rep_
Governments should make voting compulsory so the maximum number of citizens have their voices heard by their government.	Rep_
Governments should make voting compulsory so the maximum number of citizens participate in governmental elections.	Vote_
Governments should make voting compulsory so the most popular candidate wins.	Leaders_
Governments should make voting compulsory so the outcome of the election reflects the voters' will.	Rep_
Governments should make voting compulsory so the people are the ones who are physically choosing who they want to govern them and guide their country towards a better future.	Other
Governments should make voting compulsory so the people have a say.	Rep_
Governments should make voting compulsory so the people have the decision to decide.	Other
Governments should make voting compulsory so the people in those countries come out to vote.	Vote_
Governments should make voting compulsory so the people see it as a civic right not a civic duty.	Other
Governments should make voting compulsory so the person chosen is voted for by all	Leaders_Rep_
Governments should make voting compulsory so the person elected is truly elected by the majority of citizens.	Leaders_Rep_
Governments should make voting compulsory so the person elected is truly representative of the interests of the majority.	Leaders_Rep_
Governments should make voting compulsory so the person elected will represent the majority of the population.	Leaders_Rep_
Governments should make voting compulsory so the person that is elected is truly a representative of all of the people.	Leaders_Rep_
Governments should make voting compulsory so the person who is elected is representative of the majority of the citizens of that country.	Leaders_Rep_
Governments should make voting compulsory so the politicians that are elected represent the majority of the people and what they are looking for in a leader.	Leaders_Rep_
Governments should make voting compulsory so the polls increase.	Vote_
Governments should make voting compulsory so the population will have a say in who wins.	Rep_
Governments should make voting compulsory so the result is not biased.	Other
Governments should make voting compulsory so the results will present a more accurate portrait of the electorate.	Rep_
Governments should make voting compulsory so the right candidate gets into office.	Leaders_
Governments should make voting compulsory so the right person can be elected all the time.	Leaders_
Governments should make voting compulsory so the right person is elected for the job based on the peoples choice.	Leaders_Rep_
Governments should make voting compulsory so the right person will be elected.	Leaders_
Governments should make voting compulsory so the true choice of the people who are voting is made.	Other
Governments should make voting compulsory so the true desires of everyone can be known.	Rep_
Governments should make voting compulsory so the true interests of all the people in a country are represented instead of just those who care enough or have the resources to vote.	Rep_
Governments should make voting compulsory so the true will of the people is represented.	Rep_
Governments should make voting compulsory so the turnout is better and can more accurately elect representatives in public offices.	Leaders_Vote_
Governments should make voting compulsory so the uninformed may cast a ballot paid for by unethical politicians.	Other
Governments should make voting compulsory so the United States should consider adopting compulsory voting regulations.	Other
Governments should make voting compulsory so the voice of ALL the people are heard.	Rep_
Governments should make voting compulsory so the voice of the people is heard in a more complete manner.	Rep_
Governments should make voting compulsory so the voice of what the people really want is heard.	Rep_
Governments should make voting compulsory so the vote count stays at a fairly high level.	Vote_
Governments should make voting compulsory so the vote will be a true choice of people.	Other
Governments should make voting compulsory so the voted in official better represents the needs of the whole community.	Leaders_Rep_
Governments should make voting compulsory so the voter turnout does not drastically decline.	Vote_
Governments should make voting compulsory so the voter turnout is higher.	Vote_
Governments should make voting compulsory so the voter turnout is larger.	Vote_
Governments should make voting compulsory so the voter turnout raises.	Vote_
Governments should make voting compulsory so the voters would not feel to apathetic about politics and actually get involved in what's going on.	Apathy_
Governments should make voting compulsory so the votes are accurate and can have a reliable elections or votes that the people are required to do.	Other
Governments should make voting compulsory so the will of everyone can be represented.	Rep_
Governments should make voting compulsory so the will of the country's population is directly involved in shaping the government and direction it needs.	Rep_
Governments should make voting compulsory so the will of the people is properly represented.	Rep_
Governments should make voting compulsory so their democracy has a representative government.	Rep_
Governments should make voting compulsory so then all citizens would be responsible for election results.	Other
Governments should make voting compulsory so there is a better representation from the constituents.	Rep_
Governments should make voting compulsory so there is a maximally representative census of the will of the people	Rep_
Governments should make voting compulsory so there is a more "true" election.	Other
Governments should make voting compulsory so there is a more accurate representation of the population.	Rep_
Governments should make voting compulsory so there is a real chance for changes.	Other
Governments should make voting compulsory so there is a stronger presence of political awareness and knowledge throughout the country.	Other
Governments should make voting compulsory so there is better participation in the elections	Vote_
Governments should make voting compulsory so there is higher voter turnout in the elections.	Vote_
Governments should make voting compulsory so there is less fighting after the polls.	Other
Governments should make voting compulsory so there is no more democra8	Other
Governments should make voting compulsory so there is not a major decline in voter participation such as Venezuela who saw a 30% decrease in voters coming to the polls.	Vote_
Governments should make voting compulsory so there needs to be some negative consequence for not voting to encourage voters to participate.	Other
Governments should make voting compulsory so there should be easier ways to vote, online and absentee voting.	Other
Governments should make voting compulsory so there should be policies either in place to enforce compulsory voting or governments should create policies to transition to compulsory voting.	Other
Governments should make voting compulsory so there will be a higher turn out.	Vote_
Governments should make voting compulsory so there will be a higher turnout at the polls and citizens are motivated, by law, to vote.	Vote_
Governments should make voting compulsory so there will be no more low voter turnout and apathy.	Apathy_Vote_
Governments should make voting compulsory so there will not be a lack of the overall population taking part in political elections.	Vote_
Governments should make voting compulsory so there's more overall involvement and the whole process.	Vote_
Governments should make voting compulsory so therefore should also make civics mandatory learning in schools.	Other
Governments should make voting compulsory so theres more data to pull from	Other
Governments should make voting compulsory so they a bigger voter pool for a better election.	Vote_
Governments should make voting compulsory so they can combat issues of voter apathy which cause low voter turnouts and make government less representative of the people.	Apathy_Vote_Rep_
Governments should make voting compulsory so they can combat low voter turnout and ensure that government is truly representative of the people. 	Vote_Rep_
Governments should make voting compulsory so they can ensure that the government truly represents the will of the people by soliciting the opinions of a majority of the citizens.	Vote_Rep_
Governments should make voting compulsory so they can get a true count of the number of people that vote	Other
Governments should make voting compulsory so they can get an actual tally on all eligible voters and on their feelings in the actual political landscape.	Rep_
Governments should make voting compulsory so they can have everyone logged in the system, There would be no illegals if every single person needed to vote.	Other
Governments should make voting compulsory so they can know truly what the people want.	Rep_
Governments should make voting compulsory so they can pretend to rule by popular mandate.	Other
Governments should make voting compulsory so they can show they do not respect the freedom to say no	Other
Governments should make voting compulsory so they can survive to live another day.	Other
Governments should make voting compulsory so they get everyone's vote to count.	Rep_
Governments should make voting compulsory so they include all the citizens.	Other
Governments should make voting compulsory so they know how the country truly feels on certain issues.	Rep_
Governments should make voting compulsory so they receive the highest possible turnout of voters.	Vote_
Governments should make voting compulsory so they would have to have a punishment for people who still avoid doing it.	Other
Governments should make voting compulsory so those who cant make it to vote or do not want to will not be punished.	Other
Governments should make voting compulsory so to encourage voter participation	Vote_
Governments should make voting compulsory so to encourage voter participation.	Vote_
Governments should make voting compulsory so to encourage voters participation	Vote_
Governments should make voting compulsory so to understand people's view.	Rep_
Governments should make voting compulsory so very impartent	Other
Governments should make voting compulsory so voter apathy will no longer be a problem.	Apathy_
Governments should make voting compulsory so voter apathy won't interfere with voter turnout	Apathy_Vote_
Governments should make voting compulsory so voter participation is encouraged.	Vote_
Governments should make voting compulsory so voter participation will increase and the majority of the population will be represented in the outcome of a political election.	Leaders_Rep_
Governments should make voting compulsory so voter turn out improves.	Vote_
Governments should make voting compulsory so voter turnout goes up	Vote_
Governments should make voting compulsory so voter turnout is high.	Vote_
Governments should make voting compulsory so voter turnout is higher.	Vote_
Governments should make voting compulsory so voter turnout is higher.	Vote_
Governments should make voting compulsory so voter turnout is mandatory	Other
Governments should make voting compulsory so voter turnout is much higher.	Vote_
Governments should make voting compulsory so voter turnout is not low.	Vote_
Governments should make voting compulsory so voter turnout remains high and the majority of the population is always represented.	Vote_Rep_
Governments should make voting compulsory so voters can feel like their voice matters.	Feel_
Governments should make voting compulsory so voters ensures that the elected government represents the majority of the population.	Rep_
Governments should make voting compulsory so voters participate.	Vote_
Governments should make voting compulsory so voters will stop being apathetic and vote in elections	Apathy_Vote_
Governments should make voting compulsory so VOTES CAN BE COLLECTED MORE	Other
Governments should make voting compulsory so voting ensures that the elected government represents the majority of the population.	Rep_
Governments should make voting compulsory so voting is a civic right not duty.	Other
Governments should make voting compulsory so voting represents the population better.	Rep_
Governments should make voting compulsory so voting say that it is a violation of personal liberties and choices.	Other
Governments should make voting compulsory so voting should be made more accessible to everyone.	Other
Governments should make voting compulsory so voting should be seen as a civic right and not a civic duty.	Other
Governments should make voting compulsory so we all are hear and have someone there for us so the goverment knows how we feel about how things are being done for us but as people we need to feel free were we do it and vocal	Rep_
Governments should make voting compulsory so we are quick to make a decision.	Other
Governments should make voting compulsory so we can be ensured as a people that all of ur voices are heard in every politician that is voted to work for us.	Leaders_Rep_
Governments should make voting compulsory so we can be sure that all sides have been represented in the election results.	Rep_
Governments should make voting compulsory so we can ensure we achieve the outcome we want as a society.	Other
Governments should make voting compulsory so we can feel confident that the elected official is representative of the majority of the population, not just the majority of the people who opted to vote.	Leaders_Rep_
Governments should make voting compulsory so we can get a more accurate judgment of what people think of candidates.	Leaders_Rep_
Governments should make voting compulsory so we can get a more accurate vote as the majority will have submitted a vote.	Rep_
Governments should make voting compulsory so we can get more accurate representation of voters across the whole United States.	Rep_
Governments should make voting compulsory so we can select the good leader	Leaders_
Governments should make voting compulsory so we choose correct person.	Leaders_
Governments should make voting compulsory so we get a true measure of the people's choice.	Rep_
Governments should make voting compulsory so we should vote compulsory.	Other
Governments should make voting compulsory so we the correct person	Other
Governments should make voting compulsory so we vote the correct person	Leaders_
Governments should make voting compulsory so we vote the correct person	Leaders_
Governments should make voting compulsory so we vote the correct person	Leaders_
Governments should make voting compulsory so we vote the correct person.	Leaders_
Governments should make voting compulsory so we would have leaders in office who represent the majority.	Rep_
Governments should make voting compulsory so why don't they do it already?	Other
Governments should make voting compulsory so you have a truly participatory democracy where everyone's voice is heard.	Rep_
